 X ( ) lemma=TXT 
 X&P ( ) 
 X- ( ) 
 X-Bein ( ) 
 X-Beinen ( ) 
 X-Chromosom ( ) 
 X-Chromosomen ( ) 
 X-Chromosoms ( ) 
 X-Clan ( ) 
 X-Dorf ( ) 
 X-Form ( ) 
 X-Mal ( ) 
 X-Mas-Festival ( ) 
 X-Mas-Party ( ) 
 X-Pose ( ) 
 X-Stadt ( ) 
 X-Tal ( ) 
 X-beliebige ( ) 
 X-beliebigen ( ) 
 X. ( ) 
 XAVER ( ) 
 XL- ( ) 
 XL-Club ( ) 
 XP ( ) lemma=EXPO 
 XPO-Galerie ( ) 
 XR ( ) 
 XS- ( ) 
 XXS-Sensoren ( ) 
 XY ( ) 
 XY- ( ) 
 XY-Chromosomen-Ausstattung ( ) 
 XY-Sendung ( ) 
 XY-Zimmermann ( ) 
 XYZ ( ) 
 Xafer ( ) 
 Xanana ( ) 
 Xananas ( ) 
 Xandro ( ) 
 Xanthi ( ) 
 Xanthippe ( ) 
 Xanthippen ( ) 
 Xaver ( ) 
 Xaver-Ernst-Sportanlage ( ) 
 Xaver-F. ( ) 
 Xaver-Lorenz ( ) 
 Xaverius-Novene ( ) 
 Xavier ( ) 
 Xaxer ( ) 
 Xenia ( ) 
 Xenien ( ) 
 Xenion ( ) 
 Xenios ( ) 
 Xeno-Transplantationen ( ) 
 Xenofon ( ) 
 Xenon ( ) 
 Xenon-Kino ( ) 
 Xenophon ( ) 
 Xerox ( ) 
 Xerxes-Saddam ( ) 
 Xhavit ( ) 
 Xhevat ( ) 
 Xhevdet ( ) 
 Xhosa- ( ) 
 Xhosa-Reservat ( ) 
 Xhosa-Stammes ( ) 
 Xiang ( ) 
 Xiao ( ) 
 Xiao-Hui ( ) 
 Xiaojuan ( ) 
 Xiaoli ( ) 
 Xiaolin ( ) 
 Ximena ( ) 
 Xin-Strasse ( ) 
 Xin-Straße ( ) 
 Xin-Yu ( ) 
 Xingu-Fluss ( ) 
 Xingu-Fluß ( ) 
 Xingyue ( ) 
 Xinhua-Bericht ( ) 
 Xinjiang-Wüste ( ) 
 Xiuming ( ) 
 Xlaoying ( ) 
 Xml ( ) 
 Xrisoula ( ) 
 Xs ( ) 
 Xt ( ) 
 Xuan ( ) 
 Xuanlam ( ) 
 Xue ( ) 
 Xylophon ( ) 
 Xylophone ( ) 
 Xylophonen ( ) 
 Xylophonspieler ( ) 
 Xylophonspielerin ( ) 
 x- ( ) 
 x-Mal ( ) 
 x-beliebig ( ) 
 x-beliebige ( ) 
 x-beliebigen ( ) 
 x-beliebiger ( ) 
 x-beliebiges ( ) 
 xx- ( ) 
 x10-km-Staffe ( ) lemma=4x10-km-Staffel 
 x100-Meter-Staffe ( ) lemma=4x100-Meter-Staffel 
 x100-m ( ) lemma=4x100-m- 
 x100-m-Freistil-Staffe ( ) lemma=4x100-m-Freistil-Staffel 
 x100-m-Quartet ( ) lemma=4x100-m-Quartett 
 x100-m-Staffe ( ) lemma=4x100-m-Staffel 
 x200-Meter-Freistilkonkurren ( ) lemma=4x200-Meter-Freistilkonkurrenz 
 x200-m-Freistil-Staffe ( ) lemma=4x200-m-Freistil-Staffel 
 x200-m-Freistilstaffe ( ) lemma=4x200-m-Freistilstaffel 
 x400-Meter-Staffe ( ) lemma=4x400-Meter-Staffel 
 x400-m-Staffe ( ) lemma=4x400-m-Staffel 
 x5-km-Staffe ( ) lemma=4x5-km-Staffel 
 x7,5-km-Staffe ( ) lemma=4x7,5-km-Staffel 
 x50-m-Pendel-Hindernis-Staffe ( ) lemma=5x50-m-Pendel-Hindernis-Staffel 
 XE ( ) lemma=AXEL 
 x-Jör ( ) lemma=Ax-Jörg 
 x ( ) lemma=xx- 
 xe ( ) lemma=Axel 
 xel ( ) lemma=Axel 
 xel-Alexande ( ) lemma=Axel-Alexander 
 xel-Andersson-Akademi ( ) lemma=Axel-Andersson-Akademie 
 xel-Bern ( ) lemma=Axel-Bernd 
 xel-Carste ( ) lemma=Axel-Carsten 
 xel-Christia ( ) lemma=Axel-Christian 
 xel-Cäsar-Springer-Strass ( ) lemma=Axel-Cäsar-Springer-Straße 
 xel-Cäsar-Springer-Straß ( ) lemma=Axel-Cäsar-Springer-Straße 
 xel-Detle ( ) lemma=Axel-Detlef 
 xel-Erns ( ) lemma=Axel-Ernst 
 xel-Friedric ( ) lemma=Axel-Friedrich 
 xel-Hage ( ) lemma=Axel-Hagen 
 xel-Heinric ( ) lemma=Axel-Heinrich 
 xel-Helg ( ) lemma=Axel-Helge 
 xel-Jör ( ) lemma=Axel-Jörg 
 xel-Jür ( ) lemma=Axel-Jürg 
 xel-Jürge ( ) lemma=Axel-Jürgen 
 xel-Michae ( ) lemma=Axel-Michael 
 xel-Pete ( ) lemma=Axel-Peter 
 xel-R ( ) lemma=Axel-R. 
 xel-Raine ( ) lemma=Axel-Rainer 
 xel-Renatu ( ) lemma=Axel-Renatus 
 xel-Rüdige ( ) lemma=Axel-Rüdiger 
 xel-Springe ( ) lemma=Axel-Springer 
 xel-Springer ( ) lemma=Axel-Springer- 
 xel-Springer-Hau ( ) lemma=Axel-Springer-Haus 
 xel-Springer-Hause ( ) lemma=Axel-Springer-Haus 
 xel-Springer-Konzer ( ) lemma=Axel-Springer-Konzern 
 xel-Springer-Plat ( ) lemma=Axel-Springer-Platz 
 xel-Springer-Verla ( ) lemma=Axel-Springer-Verlag 
 xel-Springer-Verlage ( ) lemma=Axel-Springer-Verlag 
 xel-Springer-Verlag ( ) lemma=Axel-Springer-Verlag 
 xel-Steffe ( ) lemma=Axel-Steffen 
 xel-Sum ( ) lemma=Axel-Suma 
 xel-Uw ( ) lemma=Axel-Uwe 
 xel-W ( ) lemma=Axel-W. 
 xel-Werne ( ) lemma=Axel-Werner 
 xel-Wolfgang-Jürge ( ) lemma=Axel-Wolfgang-Jürgen 
 xialitä ( ) lemma=Axialität 
 xini ( ) lemma=Axinia 
 xinj ( ) lemma=Axinja 
 xio ( ) lemma=Axiom 
 xiom ( ) lemma=Axiom 
 xiome ( ) lemma=Axiom 
 xis ( ) lemma=Axis- 
 xthel ( ) lemma=Axthelm 
 xthelm ( ) lemma=Axthelm 
 xthie ( ) lemma=Axthieb 
 xthiebe ( ) lemma=Axthieb 
 xtman ( ) lemma=Axtmann 
 xtmörderi ( ) lemma=Axtmörderin 
 xtschläg ( ) lemma=Axtschlag 
 xtschläge ( ) lemma=Axtschlag 
 xtstie ( ) lemma=Axtstiel 
 xtstiel ( ) lemma=Axtstiel 
 XN-Baumwoll ( ) lemma=BXN-Baumwolle 
 X-Verbindunge ( ) lemma=DX-Verbindung 
 X-Weeken ( ) lemma=DX-Weekend 
 X-BR ( ) lemma=EX-BRD 
 X-DD ( ) lemma=EX-DDR 
 X-NPD-Che ( ) lemma=EX-NPD-Chef 
 XPO-Gegne ( ) lemma=EXPO-Gegner 
 XTR ( ) lemma=EXTRA 
 x-A ( ) lemma=Ex-AL 
 x-AL-Abgeordnet ( ) lemma=Ex-AL-Abgeordnete 
 x-AL-Abgeordnete ( ) lemma=Ex-AL-Abgeordnete 
 x-AL-Mitglie ( ) lemma=Ex-AL-Mitglied 
 x-ASt ( ) lemma=Ex-AStA 
 x-Abgeordnet ( ) lemma=Ex-Abgeordnete 
 x-Abgeordnete ( ) lemma=Ex-Abgeordnete 
 x-Abhängige ( ) lemma=Ex-Abhängige 
 x-Abteilungsche ( ) lemma=Ex-Abteilungschef 
 x-Abteilungsdirekto ( ) lemma=Ex-Abteilungsdirektor 
 x-Abteilungsleite ( ) lemma=Ex-Abteilungsleiter 
 x-Achtundsechzige ( ) lemma=Ex-Achtundsechziger 
 x-Admira ( ) lemma=Ex-Admiral 
 x-Adress ( ) lemma=Ex-Adresse 
 x-Agen ( ) lemma=Ex-Agent 
 x-Agente ( ) lemma=Ex-Agent 
 x-Aktiviste ( ) lemma=Ex-Aktivist 
 x-Alliierte ( ) lemma=Ex-Alliierte 
 x-Altenhei ( ) lemma=Ex-Altenheim 
 x-Amtsleite ( ) lemma=Ex-Amtsleiter 
 x-Angestellt ( ) lemma=Ex-Angestellte 
 x-Angestellte ( ) lemma=Ex-Angestellte 
 x-Anhänge ( ) lemma=Ex-Anhänger 
 x-Ankläge ( ) lemma=Ex-Ankläger 
 x-Anwal ( ) lemma=Ex-Anwalt 
 x-Arbeitgebe ( ) lemma=Ex-Arbeitgeber 
 x-Arbeitgeberpräsiden ( ) lemma=Ex-Arbeitgeberpräsident 
 x-Arbeitgeber ( ) lemma=Ex-Arbeitgeber 
 x-Arbeitsministe ( ) lemma=Ex-Arbeitsminister 
 x-Arbeitsministeri ( ) lemma=Ex-Arbeitsministerin 
 x-Arbeitssenato ( ) lemma=Ex-Arbeitssenator 
 x-Army-Ty ( ) lemma=Ex-Army-Typ 
 x-Arz ( ) lemma=Ex-Arzt 
 x-Aschaffenburge ( ) lemma=Ex-Aschaffenburger 
 x-Assisten ( ) lemma=Ex-Assistent 
 x-Assistenti ( ) lemma=Ex-Assistentin 
 x-Astronau ( ) lemma=Ex-Astronaut 
 x-Atmosphär ( ) lemma=Ex-Atmosphäre 
 x-Atomministe ( ) lemma=Ex-Atomminister 
 x-Aufsichtsra ( ) lemma=Ex-Aufsichtsrat 
 x-Aufsichtsratsche ( ) lemma=Ex-Aufsichtsratschef 
 x-Aufsichtsratsvorsitzende ( ) lemma=Ex-Aufsichtsratsvorsitzende 
 x-Ausländerbeauftragt ( ) lemma=Ex-Ausländerbeauftragte 
 x-Aussenministe ( ) lemma=Ex-Außenminister 
 x-Aussenminister ( ) lemma=Ex-Außenminister 
 x-Autoperforationsartiste ( ) lemma=Ex-Autoperforationsartist 
 x-Außenministe ( ) lemma=Ex-Außenminister 
 x-Außenminister ( ) lemma=Ex-Außenminister 
 x-BI-Spreche ( ) lemma=Ex-BI-Sprecher 
 x-BKA-Che ( ) lemma=Ex-BKA-Chef 
 x-BND-Che ( ) lemma=Ex-BND-Chef 
 x-BR-Chefredakteu ( ) lemma=Ex-BR-Chefredakteur 
 x-BR-TV ( ) lemma=Ex-BR-TV- 
 x-BR ( ) lemma=Ex-BRD 
 x-BRD-Befindlichkei ( ) lemma=Ex-BRD-Befindlichkeit 
 x-Ba ( ) lemma=Ex-Bad 
 x-Ban ( ) lemma=Ex-Band 
 x-Banke ( ) lemma=Ex-Banker 
 x-Bankie ( ) lemma=Ex-Bankier 
 x-Barschel-Medienreferente ( ) lemma=Ex-Barschel-Medienreferent 
 x-Bassis ( ) lemma=Ex-Bassist 
 x-Bau ( ) lemma=Ex-Bau- 
 x-Bauamtsleite ( ) lemma=Ex-Bauamtsleiter 
 x-Bauministe ( ) lemma=Ex-Bauminister 
 x-Bausenato ( ) lemma=Ex-Bausenator 
 x-Baustadtra ( ) lemma=Ex-Baustadtrat 
 x-Bautei ( ) lemma=Ex-Bauteil 
 x-Baye ( ) lemma=Ex-Bayer 
 x-Bayer ( ) lemma=Ex-Bayer 
 x-Beamt ( ) lemma=Ex-Beamter 
 x-Beamte ( ) lemma=Ex-Beamter 
 x-Beatle ( ) lemma=Ex-Beatles 
 x-Becker ( ) lemma=Ex-Becker- 
 x-Berate ( ) lemma=Ex-Berater 
 x-Bereiche ( ) lemma=Ex-Bereich 
 x-Berline ( ) lemma=Ex-Berliner 
 x-Beschäftigte ( ) lemma=Ex-Beschäftigte 
 x-Besetze ( ) lemma=Ex-Besetzer 
 x-Besetzerinne ( ) lemma=Ex-Besetzerin 
 x-Besetzer ( ) lemma=Ex-Besetzer 
 x-Besitze ( ) lemma=Ex-Besitzer 
 x-Betriebsra ( ) lemma=Ex-Betriebsrat 
 x-Bewohne ( ) lemma=Ex-Bewohner 
 x-Bezir ( ) lemma=Ex-Bezirk 
 x-Bezirksbürgermeiste ( ) lemma=Ex-Bezirksbürgermeister 
 x-Bezirksche ( ) lemma=Ex-Bezirkschef 
 x-Bildungsministeri ( ) lemma=Ex-Bildungsministerin 
 x-Bildungssenato ( ) lemma=Ex-Bildungssenator 
 x-Bino-Puppenspiele ( ) lemma=Ex-Bino-Puppenspieler 
 x-Bischo ( ) lemma=Ex-Bischof 
 x-Blankenburge ( ) lemma=Ex-Blankenburger 
 x-Blockflöte ( ) lemma=Ex-Blockflöte 
 x-Blockflötenspiele ( ) lemma=Ex-Blockflötenspieler 
 x-Blockparte ( ) lemma=Ex-Blockpartei 
 x-Blockparteie ( ) lemma=Ex-Blockpartei 
 x-Bochume ( ) lemma=Ex-Bochumer 
 x-Bonne ( ) lemma=Ex-Bonner 
 x-Bordell ( ) lemma=Ex-Bordell 
 x-Boruss ( ) lemma=Ex-Borusse 
 x-Bosch-Che ( ) lemma=Ex-Bosch-Chef 
 x-Bos ( ) lemma=Ex-Boss 
 x-Botschafte ( ) lemma=Ex-Botschafter 
 x-Botschafteri ( ) lemma=Ex-Botschafterin 
 x-Boxe ( ) lemma=Ex-Boxer 
 x-Boxweltmeiste ( ) lemma=Ex-Boxweltmeister 
 x-Bo ( ) lemma=Ex-Boss 
 x-Brandschützer ( ) lemma=Ex-Brandschützer 
 x-Braunschweige ( ) lemma=Ex-Braunschweiger 
 x-Breme ( ) lemma=Ex-Bremer 
 x-Bremeri ( ) lemma=Ex-Bremerin 
 x-Bremer ( ) lemma=Ex-Bremer 
 x-Brüder ( ) lemma=Ex-Bruder 
 x-Bull ( ) lemma=Ex-Bulle 
 x-Bundesaussenministe ( ) lemma=Ex-Bundesaußenminister 
 x-Bundesaußenministe ( ) lemma=Ex-Bundesaußenminister 
 x-Bundesbankpräsiden ( ) lemma=Ex-Bundesbankpräsident 
 x-Bundesbildungsministe ( ) lemma=Ex-Bundesbildungsminister 
 x-Bundesforschungsministe ( ) lemma=Ex-Bundesforschungsminister 
 x-Bundesgeschäftsführe ( ) lemma=Ex-Bundesgeschäftsführer 
 x-Bundesjustizministe ( ) lemma=Ex-Bundesjustizminister 
 x-Bundeskanzle ( ) lemma=Ex-Bundeskanzler 
 x-Bundeskanzler ( ) lemma=Ex-Bundeskanzler 
 x-Bundesligaprofi ( ) lemma=Ex-Bundesligaprofi 
 x-Bundesligaspiele ( ) lemma=Ex-Bundesligaspieler 
 x-Bundesligaspieleri ( ) lemma=Ex-Bundesligaspielerin 
 x-Bundesligatraine ( ) lemma=Ex-Bundesligatrainer 
 x-Bundesministe ( ) lemma=Ex-Bundesminister 
 x-Bundespräsiden ( ) lemma=Ex-Bundespräsident 
 x-Bundespräsidente ( ) lemma=Ex-Bundespräsident 
 x-Bundesräti ( ) lemma=Ex-Bundesrätin 
 x-Bundestagsabgeordnet ( ) lemma=Ex-Bundestagsabgeordnete 
 x-Bundestagsabgeordnete ( ) lemma=Ex-Bundestagsabgeordnete 
 x-Bundestagspräsiden ( ) lemma=Ex-Bundestagspräsident 
 x-Bundestraine ( ) lemma=Ex-Bundestrainer 
 x-Bundesverfassungsrichte ( ) lemma=Ex-Bundesverfassungsrichter 
 x-Bundesverkehrsministe ( ) lemma=Ex-Bundesverkehrsminister 
 x-Bundesverteidigungsministe ( ) lemma=Ex-Bundesverteidigungsminister 
 x-Bundesvorstandssprecheri ( ) lemma=Ex-Bundesvorstandssprecherin 
 x-Bundeswehrleutnan ( ) lemma=Ex-Bundeswehrleutnant 
 x-Bundeswirtschaftsministe ( ) lemma=Ex-Bundeswirtschaftsminister 
 x-Bäcke ( ) lemma=Ex-Bäcker 
 x-Bürge ( ) lemma=Ex-Bürger 
 x-Bürgermeiste ( ) lemma=Ex-Bürgermeister 
 x-Bürgermeisteri ( ) lemma=Ex-Bürgermeisterin 
 x-Bürgermeisterinne ( ) lemma=Ex-Bürgermeisterin 
 x-Bürgermeister ( ) lemma=Ex-Bürgermeister 
 x-Bürgerrechtle ( ) lemma=Ex-Bürgerrechtler 
 x-Bürgerschaftsabgeordnet ( ) lemma=Ex-Bürgerschaftsabgeordnete 
 x-Bürgerschaftsabgeordnete ( ) lemma=Ex-Bürgerschaftsabgeordnete 
 x-Büroleite ( ) lemma=Ex-Büroleiter 
 x-CD ( ) lemma=Ex-CDU 
 x-CDU ( ) lemma=Ex-CDU- 
 x-CDU-Che ( ) lemma=Ex-CDU-Chef 
 x-CDU-Fraktionsche ( ) lemma=Ex-CDU-Fraktionschef 
 x-CDU-Geschäftsführe ( ) lemma=Ex-CDU-Geschäftsführer 
 x-CDU-Mitglie ( ) lemma=Ex-CDU-Mitglied 
 x-CDU-Politike ( ) lemma=Ex-CDU-Politiker 
 x-CDU-Stadtverordnet ( ) lemma=Ex-CDU-Stadtverordnete 
 x-CDU-Stadtverordnete ( ) lemma=Ex-CDU-Stadtverordnete 
 x-CI ( ) lemma=Ex-CIA 
 x-CIA ( ) lemma=Ex-CIA- 
 x-CIA-Che ( ) lemma=Ex-CIA-Chef 
 x-CIA-Direkto ( ) lemma=Ex-CIA-Direktor 
 x-CIA-Man ( ) lemma=Ex-CIA-Mann 
 x-CIA-Mitarbeite ( ) lemma=Ex-CIA-Mitarbeiter 
 x-CSF ( ) lemma=Ex-CSFR 
 x-CSU-Che ( ) lemma=Ex-CSU-Chef 
 x-CSU-Fraktionviz ( ) lemma=Ex-CSU-Fraktionvize 
 x-CSU-Man ( ) lemma=Ex-CSU-Mann 
 x-Cell- ( ) lemma=Ex-Cell-O 
 x-Cell-O-Konzer ( ) lemma=Ex-Cell-O-Konzern 
 x-Che ( ) lemma=Ex-Chef 
 x-Chefarz ( ) lemma=Ex-Chefarzt 
 x-Chefi ( ) lemma=Ex-Chefin 
 x-Chefinne ( ) lemma=Ex-Chefin 
 x-Chefredakteu ( ) lemma=Ex-Chefredakteur 
 x-Chefrentenhändle ( ) lemma=Ex-Chefrentenhändler 
 x-Chef ( ) lemma=Ex-Chef 
 x-Chemnitze ( ) lemma=Ex-Chemnitzer 
 x-Christdemokra ( ) lemma=Ex-Christdemokrat 
 x-Christdemokrate ( ) lemma=Ex-Christdemokrat 
 x-Clu ( ) lemma=Ex-Club 
 x-C ( ) lemma=Ex-Co 
 x-Container ( ) lemma=Ex-Container- 
 x-Conti-Che ( ) lemma=Ex-Conti-Chef 
 x-Contra-Führe ( ) lemma=Ex-Contra-Führer 
 x-Coop-Che ( ) lemma=Ex-Coop-Chef 
 x-DA-Che ( ) lemma=Ex-DA-Chef 
 x-DD ( ) lemma=ex-DDR 
 x-DDR ( ) lemma=Ex-DDR- 
 x-DDR-Autore ( ) lemma=Ex-DDR-Autor 
 x-DDR-Ban ( ) lemma=Ex-DDR-Band 
 x-DDR-Bauministe ( ) lemma=Ex-DDR-Bauminister 
 x-DDR-Betrieb ( ) lemma=Ex-DDR-Betrieb 
 x-DDR-Bevölkerun ( ) lemma=Ex-DDR-Bevölkerung 
 x-DDR-Bürge ( ) lemma=Ex-DDR-Bürger 
 x-DDR-Bürger ( ) lemma=Ex-DDR-Bürger 
 x-DDR-Bürgerrechtle ( ) lemma=Ex-DDR-Bürgerrechtler 
 x-DDR-Bürgerrechtler ( ) lemma=Ex-DDR-Bürgerrechtler 
 x-DDR-Che ( ) lemma=Ex-DDR-Chef 
 x-DDR-Chef ( ) lemma=Ex-DDR-Chef 
 x-DDR-Devisenagente ( ) lemma=Ex-DDR-Devisenagent 
 x-DDR-Diplomate ( ) lemma=Ex-DDR-Diplomat 
 x-DDR-Dramatike ( ) lemma=Ex-DDR-Dramatiker 
 x-DDR-Fernsehe ( ) lemma=Ex-DDR-Fernsehen 
 x-DDR-Fraue ( ) lemma=Ex-DDR-Frau 
 x-DDR-Generalstaatsanwal ( ) lemma=Ex-DDR-Generalstaatsanwalt 
 x-DDR-Grenzsoldate ( ) lemma=Ex-DDR-Grenzsoldat 
 x-DDR-Größe ( ) lemma=Ex-DDR-Größe 
 x-DDR-Innenministe ( ) lemma=Ex-DDR-Innenminister 
 x-DDR-Journaliste ( ) lemma=Ex-DDR-Journalist 
 x-DDR-Juriste ( ) lemma=Ex-DDR-Jurist 
 x-DDR-Künstler ( ) lemma=Ex-DDR-Künstler 
 x-DDR-Landwirtschaf ( ) lemma=Ex-DDR-Landwirtschaft 
 x-DDR-Liedermache ( ) lemma=Ex-DDR-Liedermacher 
 x-DDR-Länder ( ) lemma=Ex-DDR-Land 
 x-DDR-Mark ( ) lemma=Ex-DDR-Marke 
 x-DDR-Ministe ( ) lemma=Ex-DDR-Minister 
 x-DDR-Ministerpräsiden ( ) lemma=Ex-DDR-Ministerpräsident 
 x-DDR-Ministerpräsidente ( ) lemma=Ex-DDR-Ministerpräsident 
 x-DDR-Nazi ( ) lemma=Ex-DDR-Nazi 
 x-DDR-Oppositio ( ) lemma=Ex-DDR-Opposition 
 x-DDR-Parteie ( ) lemma=Ex-DDR-Partei 
 x-DDR-Politike ( ) lemma=Ex-DDR-Politiker 
 x-DDR-Regierungsche ( ) lemma=Ex-DDR-Regierungschef 
 x-DDR-Regisseu ( ) lemma=Ex-DDR-Regisseur 
 x-DDR-Richte ( ) lemma=Ex-DDR-Richter 
 x-DDR-Richteri ( ) lemma=Ex-DDR-Richterin 
 x-DDR-Rundfun ( ) lemma=Ex-DDR-Rundfunk 
 x-DDR-Schriftstelle ( ) lemma=Ex-DDR-Schriftsteller 
 x-DDR-Schwimme ( ) lemma=Ex-DDR-Schwimmer 
 x-DDR-Spiele ( ) lemma=Ex-DDR-Spieler 
 x-DDR-Spionageche ( ) lemma=Ex-DDR-Spionagechef 
 x-DDR-Spion ( ) lemma=Ex-DDR-Spion 
 x-DDR-Spitzenfunktionär ( ) lemma=Ex-DDR-Spitzenfunktionär 
 x-DDR-Staats ( ) lemma=Ex-DDR-Staats- 
 x-DDR-Staatsche ( ) lemma=Ex-DDR-Staatschef 
 x-DDR-Staatschef ( ) lemma=Ex-DDR-Staatschef 
 x-DDR-Territoriu ( ) lemma=Ex-DDR-Territorium 
 x-DDR-Territorium ( ) lemma=Ex-DDR-Territorium 
 x-DDR-Theate ( ) lemma=Ex-DDR-Theater 
 x-DDR-Traine ( ) lemma=Ex-DDR-Trainer 
 x-DDR-Unterhändle ( ) lemma=Ex-DDR-Unterhändler 
 x-DDR-Unternehme ( ) lemma=Ex-DDR-Unternehmen 
 x-DDR-Verteidigungsministe ( ) lemma=Ex-DDR-Verteidigungsminister 
 x-DDR-Vertragsarbeite ( ) lemma=Ex-DDR-Vertragsarbeiter 
 x-DGB-Che ( ) lemma=Ex-DGB-Chef 
 x-DKP-Mitgliede ( ) lemma=Ex-DKP-Mitglied 
 x-DVU-Abgeordnet ( ) lemma=Ex-DVU-Abgeordnete 
 x-DVU-Abgeordnete ( ) lemma=Ex-DVU-Abgeordnete 
 x-Darmstädte ( ) lemma=Ex-Darmstädter 
 x-Daviscup-Kapitä ( ) lemma=Ex-Daviscup-Kapitän 
 x-Deale ( ) lemma=Ex-Dealer 
 x-Deka ( ) lemma=Ex-Dekan 
 x-Deponi ( ) lemma=Ex-Deponie 
 x-Diepgen-Mitarbeite ( ) lemma=Ex-Diepgen-Mitarbeiter 
 x-Diktato ( ) lemma=Ex-Diktator 
 x-Diktatore ( ) lemma=Ex-Diktator 
 x-Diktator ( ) lemma=Ex-Diktator 
 x-Diploma ( ) lemma=Ex-Diplomat 
 x-Diplomate ( ) lemma=Ex-Diplomat 
 x-Direkto ( ) lemma=Ex-Direktor 
 x-Dissiden ( ) lemma=Ex-Dissident 
 x-Dissidente ( ) lemma=Ex-Dissident 
 x-Dortmunde ( ) lemma=Ex-Dortmunder 
 x-Dresdene ( ) lemma=Ex-Dresdener 
 x-Dresdne ( ) lemma=Ex-Dresdner 
 x-Dresdneri ( ) lemma=Ex-Dresdnerin 
 x-Drogenabhängig ( ) lemma=Ex-Drogenabhängige 
 x-Drogenabhängige ( ) lemma=Ex-Drogenabhängige 
 x-Dynam ( ) lemma=Ex-Dynamo 
 x-Dynamo ( ) lemma=Ex-Dynamo 
 x-Düsseldorfe ( ) lemma=Ex-Düsseldorfer 
 x-EG-Kommissa ( ) lemma=Ex-EG-Kommissar 
 x-ERC-Torwar ( ) lemma=Ex-ERC-Torwart 
 x-Ehefra ( ) lemma=Ex-Ehefrau 
 x-Ehefraue ( ) lemma=Ex-Ehefrau 
 x-Eheleut ( ) lemma=Ex-Eheleute 
 x-Eheman ( ) lemma=Ex-Ehemann 
 x-Ehemänne ( ) lemma=Ex-Ehemann 
 x-Ehemänner ( ) lemma=Ex-Ehemann 
 x-Ehepartner ( ) lemma=Ex-Ehepartner 
 x-Eigentüme ( ) lemma=Ex-Eigentümer 
 x-Einheitsparte ( ) lemma=Ex-Einheitspartei 
 x-Einkaufsleite ( ) lemma=Ex-Einkaufsleiter 
 x-Emigrante ( ) lemma=Ex-Emigrant 
 x-Engelbecken-Bewohne ( ) lemma=Ex-Engelbecken-Bewohner 
 x-Erfurte ( ) lemma=Ex-Erfurter 
 x-Erstligaspieler ( ) lemma=Ex-Erstligaspieler 
 x-Essene ( ) lemma=Ex-Essener 
 x-Europameiste ( ) lemma=Ex-Europameister 
 x-Europameisteri ( ) lemma=Ex-Europameisterin 
 x-Europaparlamentarie ( ) lemma=Ex-Europaparlamentarier 
 x-FDG ( ) lemma=Ex-FDGB 
 x-FDGB-Che ( ) lemma=Ex-FDGB-Chef 
 x-FDGB-Zeitun ( ) lemma=Ex-FDGB-Zeitung 
 x-FDJ-Che ( ) lemma=Ex-FDJ-Chef 
 x-FD ( ) lemma=Ex-FDP 
 x-FDP-Che ( ) lemma=Ex-FDP-Chef 
 x-FDP-Man ( ) lemma=Ex-FDP-Mann 
 x-FDP-Vorsitzend ( ) lemma=Ex-FDP-Vorsitzende 
 x-Fahre ( ) lemma=Ex-Fahrer 
 x-Faschingsprin ( ) lemma=Ex-Faschingsprinz 
 x-Faschis ( ) lemma=Ex-Faschist 
 x-Favorite ( ) lemma=Ex-Favorit 
 x-Fein ( ) lemma=Ex-Feind 
 x-Feldwebe ( ) lemma=Ex-Feldwebel 
 x-Feuerwehrman ( ) lemma=Ex-Feuerwehrmann 
 x-Filmemache ( ) lemma=Ex-Filmemacher 
 x-Filmemacher ( ) lemma=Ex-Filmemacher 
 x-Finanzamtsche ( ) lemma=Ex-Finanzamtschef 
 x-Finanzministe ( ) lemma=Ex-Finanzminister 
 x-Finanzminister ( ) lemma=Ex-Finanzminister 
 x-Finanzsenato ( ) lemma=Ex-Finanzsenator 
 x-Finanzstaatssekretä ( ) lemma=Ex-Finanzstaatssekretär 
 x-Finanzvorstan ( ) lemma=Ex-Finanzvorstand 
 x-Firm ( ) lemma=Ex-Firma 
 x-Firmenche ( ) lemma=Ex-Firmenchef 
 x-First-Lad ( ) lemma=Ex-First-Lady 
 x-Flick-Manage ( ) lemma=Ex-Flick-Manager 
 x-Flottenadmira ( ) lemma=Ex-Flottenadmiral 
 x-Flottillenadmira ( ) lemma=Ex-Flottillenadmiral 
 x-Forschungsministe ( ) lemma=Ex-Forschungsminister 
 x-Fraktionsche ( ) lemma=Ex-Fraktionschef 
 x-Fraktionsvorsitzend ( ) lemma=Ex-Fraktionsvorsitzende 
 x-Frankfurte ( ) lemma=Ex-Frankfurter 
 x-Frankfurter ( ) lemma=Ex-Frankfurter 
 x-Fra ( ) lemma=Ex-Frau 
 x-Fraue ( ) lemma=Ex-Frau 
 x-Frauenbeauftragt ( ) lemma=Ex-Frauenbeauftragte 
 x-Frauensenatori ( ) lemma=Ex-Frauensenatorin 
 x-Fremdenlegionä ( ) lemma=Ex-Fremdenlegionär 
 x-Freun ( ) lemma=Ex-Freund 
 x-Freund ( ) lemma=Ex-Freund 
 x-Freunde ( ) lemma=Ex-Freund 
 x-Freundi ( ) lemma=Ex-Freundin 
 x-Freundinne ( ) lemma=Ex-Freundin 
 x-Funktionä ( ) lemma=Ex-Funktionär 
 x-Funktionär ( ) lemma=Ex-Funktionär 
 x-Fussballe ( ) lemma=Ex-Fußballer 
 x-Fussballnationalspiele ( ) lemma=Ex-Fußballnationalspieler 
 x-Fussballsta ( ) lemma=Ex-Fußballstar 
 x-Fußballe ( ) lemma=Ex-Fußballer 
 x-Fußballnationalspiele ( ) lemma=Ex-Fußballnationalspieler 
 x-Fußballprof ( ) lemma=Ex-Fußballprofi 
 x-Fußballsta ( ) lemma=Ex-Fußballstar 
 x-Führe ( ) lemma=Ex-Führer 
 x-GAL-Abgeordnet ( ) lemma=Ex-GAL-Abgeordnete 
 x-GAL-Abgeordnete ( ) lemma=Ex-GAL-Abgeordnete 
 x-G ( ) lemma=Ex-GI 
 x-Gangste ( ) lemma=Ex-Gangster 
 x-Gartenamtsche ( ) lemma=Ex-Gartenamtschef 
 x-Gastwir ( ) lemma=Ex-Gastwirt 
 x-Gatt ( ) lemma=Ex-Gatte 
 x-Gatte ( ) lemma=Ex-Gatte 
 x-Gatti ( ) lemma=Ex-Gattin 
 x-Gauleite ( ) lemma=Ex-Gauleiter 
 x-Gefah ( ) lemma=Ex-Gefahr 
 x-Gefangen ( ) lemma=Ex-Gefangene 
 x-Gefangene ( ) lemma=Ex-Gefangene 
 x-Gefreite ( ) lemma=Ex-Gefreiter 
 x-Gegne ( ) lemma=Ex-Gegner 
 x-Geheimagen ( ) lemma=Ex-Geheimagent 
 x-Geheimagenti ( ) lemma=Ex-Geheimagentin 
 x-Geheimdiens ( ) lemma=Ex-Geheimdienst 
 x-Geheimdienstche ( ) lemma=Ex-Geheimdienstchef 
 x-Geheimdienstchef ( ) lemma=Ex-Geheimdienstchef 
 x-Geheimdienstman ( ) lemma=Ex-Geheimdienstmann 
 x-Geise ( ) lemma=Ex-Geisel 
 x-Geisel ( ) lemma=Ex-Geisel 
 x-Geliebt ( ) lemma=Ex-Geliebte 
 x-Geliebte ( ) lemma=Ex-Geliebte 
 x-Gelnhausene ( ) lemma=Ex-Gelnhausener 
 x-Gemeindera ( ) lemma=Ex-Gemeinderat 
 x-Genera ( ) lemma=Ex-General 
 x-Generalbundesanwal ( ) lemma=Ex-Generalbundesanwalt 
 x-Generaldirekto ( ) lemma=Ex-Generaldirektor 
 x-Generalmajo ( ) lemma=Ex-Generalmajor 
 x-Generalobers ( ) lemma=Ex-Generaloberst 
 x-General ( ) lemma=Ex-General 
 x-Generalsekretä ( ) lemma=Ex-Generalsekretär 
 x-Generalstaatsanwal ( ) lemma=Ex-Generalstaatsanwalt 
 x-Generalstabsche ( ) lemma=Ex-Generalstabschef 
 x-Generäl ( ) lemma=Ex-General 
 x-Generäle ( ) lemma=Ex-General 
 x-Genesi ( ) lemma=Ex-Genesis 
 x-Genesis-Sänge ( ) lemma=Ex-Genesis-Sänger 
 x-Genoss ( ) lemma=Ex-Genosse 
 x-Genosse ( ) lemma=Ex-Genosse 
 x-Genossi ( ) lemma=Ex-Genossin 
 x-Geschäftsführe ( ) lemma=Ex-Geschäftsführer 
 x-Gesundheits ( ) lemma=Ex-Gesundheits- 
 x-Gesundheitsministe ( ) lemma=Ex-Gesundheitsminister 
 x-Gesundheitsminister ( ) lemma=Ex-Gesundheitsminister 
 x-Gesundheitsreferen ( ) lemma=Ex-Gesundheitsreferent 
 x-Gesundheitsreferente ( ) lemma=Ex-Gesundheitsreferent 
 x-Gesundheitssenato ( ) lemma=Ex-Gesundheitssenator 
 x-Gesundheitssenatori ( ) lemma=Ex-Gesundheitssenatorin 
 x-Gewerkschafte ( ) lemma=Ex-Gewerkschafter 
 x-Gewerkschaftsban ( ) lemma=Ex-Gewerkschaftsbank 
 x-Gewerkschaftsführe ( ) lemma=Ex-Gewerkschaftsführer 
 x-Gitarris ( ) lemma=Ex-Gitarrist 
 x-Gladbache ( ) lemma=Ex-Gladbacher 
 x-Gorbatschow-Berate ( ) lemma=Ex-Gorbatschow-Berater 
 x-Gouverneu ( ) lemma=Ex-Gouverneur 
 x-Gouverneur ( ) lemma=Ex-Gouverneur 
 x-Greenpeace-Aktivisti ( ) lemma=Ex-Greenpeace-Aktivistin 
 x-Greenpeace-Fra ( ) lemma=Ex-Greenpeace-Frau 
 x-Grenz ( ) lemma=Ex-Grenze 
 x-Grenzsolda ( ) lemma=Ex-Grenzsoldat 
 x-Grenzsoldate ( ) lemma=Ex-Grenzsoldat 
 x-Grosswallstädte ( ) lemma=Ex-Großwallstädter 
 x-Großwallstädte ( ) lemma=Ex-Großwallstädter 
 x-Grundbesitze ( ) lemma=Ex-Grundbesitzer 
 x-Grösse ( ) lemma=Ex-Größe 
 x-Größe ( ) lemma=Ex-Größe 
 x-Grün ( ) lemma=Ex-Grüne 
 x-Grüne ( ) lemma=Ex-Grüner 
 x-Guerill ( ) lemma=Ex-Guerilla 
 x-Guerillache ( ) lemma=Ex-Guerillachef 
 x-Guerillaführe ( ) lemma=Ex-Guerillaführer 
 x-Guerillakommandan ( ) lemma=Ex-Guerillakommandant 
 x-Gueriller ( ) lemma=Ex-Guerillero 
 x-Guerillero ( ) lemma=Ex-Guerillero 
 x-H ( ) lemma=Ex-HO 
 x-Hafenkaise ( ) lemma=Ex-Hafenkaiser 
 x-Halbstad ( ) lemma=Ex-Halbstadt 
 x-Hamburge ( ) lemma=Ex-Hamburger 
 x-Hanaue ( ) lemma=Ex-Hanauer 
 x-Hauptman ( ) lemma=Ex-Hauptmann 
 x-Hauptstad ( ) lemma=Ex-Hauptstadt 
 x-Hausbesetze ( ) lemma=Ex-Hausbesetzer 
 x-Herausgebe ( ) lemma=Ex-Herausgeber 
 x-Homburge ( ) lemma=Ex-Homburger 
 x-Hote ( ) lemma=Ex-Hotel 
 x-Häftlin ( ) lemma=Ex-Häftling 
 x-Häftling ( ) lemma=Ex-Häftling 
 x-Höchste ( ) lemma=Ex-Höchste 
 x-I ( ) lemma=Ex-IM 
 x-Ideal-Gitarris ( ) lemma=Ex-Ideal-Gitarrist 
 x-Imhausen-Che ( ) lemma=Ex-Imhausen-Chef 
 x-Industrieministe ( ) lemma=Ex-Industrieminister 
 x-Ingolstädte ( ) lemma=Ex-Ingolstädter 
 x-Inhaftiert ( ) lemma=Ex-Inhaftierte 
 x-Innenministe ( ) lemma=Ex-Innenminister 
 x-Innenminister ( ) lemma=Ex-Innenminister 
 x-Innensenato ( ) lemma=Ex-Innensenator 
 x-Innensenatore ( ) lemma=Ex-Innensenator 
 x-Innensenator ( ) lemma=Ex-Innensenator 
 x-Innenstadtra ( ) lemma=Ex-Innenstadtrat 
 x-Insass ( ) lemma=Ex-Insasse 
 x-Intendan ( ) lemma=Ex-Intendant 
 x-Intendante ( ) lemma=Ex-Intendant 
 x-International ( ) lemma=Ex-Internationale 
 x-Internationale ( ) lemma=Ex-Internationale 
 x-Interniert ( ) lemma=Ex-Internierte 
 x-JU-Mitglie ( ) lemma=Ex-JU-Mitglied 
 x-Jenaer ( ) lemma=Ex-Jenaer 
 x-Journalis ( ) lemma=Ex-Journalist 
 x-Journaliste ( ) lemma=Ex-Journalist 
 x-Jugoslaw ( ) lemma=Ex-Jugoslawe 
 x-Jugoslawe ( ) lemma=Ex-Jugoslawe 
 x-Jugoslawie ( ) lemma=Ex-Jugoslawien 
 x-Jugoslawien ( ) lemma=Ex-Jugoslawien 
 x-Jugoslawien-Konferen ( ) lemma=Ex-Jugoslawien-Konferenz 
 x-Juriste ( ) lemma=Ex-Jurist 
 x-Juso-Vorsitzende ( ) lemma=Ex-Juso-Vorsitzende 
 x-Justiz-Senato ( ) lemma=Ex-Justiz-Senator 
 x-Justizministe ( ) lemma=Ex-Justizminister 
 x-Justizministeri ( ) lemma=Ex-Justizministerin 
 x-Justizminister ( ) lemma=Ex-Justizminister 
 x-Justizsenato ( ) lemma=Ex-Justizsenator 
 x-Justizsenatori ( ) lemma=Ex-Justizsenatorin 
 x-KB ( ) lemma=Ex-KBW 
 x-KGB ( ) lemma=Ex-KGB- 
 x-KGB-Agen ( ) lemma=Ex-KGB-Agent 
 x-KGB-Che ( ) lemma=Ex-KGB-Chef 
 x-KGB-Genera ( ) lemma=Ex-KGB-General 
 x-K ( ) lemma=Ex-KP 
 x-KP-Che ( ) lemma=Ex-KP-Chef 
 x-Kaise ( ) lemma=Ex-Kaiser 
 x-Kaiser ( ) lemma=Ex-Kaiser 
 x-Kamerade ( ) lemma=Ex-Kamerad 
 x-Kampfgefährte ( ) lemma=Ex-Kampfgefährte 
 x-Kanzle ( ) lemma=Ex-Kanzler 
 x-Kanzlerberate ( ) lemma=Ex-Kanzlerberater 
 x-Kanzler ( ) lemma=Ex-Kanzler 
 x-Kapitä ( ) lemma=Ex-Kapitän 
 x-Kasern ( ) lemma=Ex-Kaserne 
 x-Kaserne ( ) lemma=Ex-Kaserne 
 x-Keepe ( ) lemma=Ex-Keeper 
 x-Kellne ( ) lemma=Ex-Kellner 
 x-Kerbebursche ( ) lemma=Ex-Kerbebursche 
 x-Kettenrauche ( ) lemma=Ex-Kettenraucher 
 x-Kicke ( ) lemma=Ex-Kicker 
 x-Kindersta ( ) lemma=Ex-Kinderstar 
 x-Kin ( ) lemma=Ex-Kino 
 x-Kirby-Mitarbeite ( ) lemma=Ex-Kirby-Mitarbeiter 
 x-Klansman ( ) lemma=Ex-Klansmann 
 x-Klassenlehreri ( ) lemma=Ex-Klassenlehrerin 
 x-Klinikche ( ) lemma=Ex-Klinikchef 
 x-Klu ( ) lemma=Ex-Klub 
 x-Kneip ( ) lemma=Ex-Kneipe 
 x-Koalitionspartneri ( ) lemma=Ex-Koalitionspartnerin 
 x-Kollaborateu ( ) lemma=Ex-Kollaborateur 
 x-Kolleg ( ) lemma=Ex-Kollege 
 x-Kollege ( ) lemma=Ex-Kollege 
 x-Kollegi ( ) lemma=Ex-Kollegin 
 x-Kolonialmach ( ) lemma=Ex-Kolonialmacht 
 x-Koloni ( ) lemma=Ex-Kolonie 
 x-Kolonie ( ) lemma=Ex-Kolonie 
 x-Kombina ( ) lemma=Ex-Kombinat 
 x-Kombinat ( ) lemma=Ex-Kombinat 
 x-Kombinate ( ) lemma=Ex-Kombinat 
 x-Komike ( ) lemma=Ex-Komiker 
 x-Kommandan ( ) lemma=Ex-Kommandant 
 x-Kommandeu ( ) lemma=Ex-Kommandeur 
 x-Kommissionsmitarbeite ( ) lemma=Ex-Kommissionsmitarbeiter 
 x-Kommunard ( ) lemma=Ex-Kommunarde 
 x-Kommunarde ( ) lemma=Ex-Kommunarde 
 x-Kommunis ( ) lemma=Ex-Kommunist 
 x-Kommuniste ( ) lemma=Ex-Kommunist 
 x-Kommunisti ( ) lemma=Ex-Kommunistin 
 x-Kondito ( ) lemma=Ex-Konditor 
 x-Kongresshall ( ) lemma=Ex-Kongresshalle 
 x-Kongreßhall ( ) lemma=Ex-Kongresshalle 
 x-Konzernche ( ) lemma=Ex-Konzernchef 
 x-Korresponden ( ) lemma=Ex-Korrespondent 
 x-Kreisvorsitzende ( ) lemma=Ex-Kreisvorsitzende 
 x-Kreuzberge ( ) lemma=Ex-Kreuzberger 
 x-Kriegsgegne ( ) lemma=Ex-Kriegsgegner 
 x-Kriminalhauptkommissa ( ) lemma=Ex-Kriminalhauptkommissar 
 x-Kripo-Che ( ) lemma=Ex-Kripo-Chef 
 x-Krupp-Che ( ) lemma=Ex-Krupp-Chef 
 x-Ku-Klux-Kla ( ) lemma=Ex-Ku-Klux-Klan 
 x-Kultu ( ) lemma=Ex-Kultur 
 x-Kulturdezernen ( ) lemma=Ex-Kulturdezernent 
 x-Kulturministe ( ) lemma=Ex-Kulturminister 
 x-Kulturministeri ( ) lemma=Ex-Kulturministerin 
 x-Kulturreferen ( ) lemma=Ex-Kulturreferent 
 x-Kultursenato ( ) lemma=Ex-Kultursenator 
 x-Kultusministe ( ) lemma=Ex-Kultusminister 
 x-Kumpan ( ) lemma=Ex-Kumpan 
 x-Kumpe ( ) lemma=Ex-Kumpel 
 x-Kunststuden ( ) lemma=Ex-Kunststudent 
 x-Kurierfahre ( ) lemma=Ex-Kurierfahrer 
 x-Kämpfe ( ) lemma=Ex-Kämpfer 
 x-Kölne ( ) lemma=Ex-Kölner 
 x-Kölner ( ) lemma=Ex-Kölner 
 x-Köni ( ) lemma=Ex-König 
 x-Königi ( ) lemma=Ex-Königin 
 x-König ( ) lemma=Ex-König 
 x-LDPD-Che ( ) lemma=Ex-LDPD-Chef 
 x-LP ( ) lemma=Ex-LPG 
 x-Landesche ( ) lemma=Ex-Landeschef 
 x-Landespolizeidirekto ( ) lemma=Ex-Landespolizeidirektor 
 x-Landesvate ( ) lemma=Ex-Landesvater 
 x-Landesvorsitzend ( ) lemma=Ex-Landesvorsitzende 
 x-Landesvorsitzende ( ) lemma=Ex-Landesvorsitzende 
 x-Landra ( ) lemma=Ex-Landrat 
 x-Landrät ( ) lemma=Ex-Landrat 
 x-Landshute ( ) lemma=Ex-Landshuter 
 x-Landtagsabgeordnet ( ) lemma=Ex-Landtagsabgeordnete 
 x-Landtagsabgeordnete ( ) lemma=Ex-Landtagsabgeordnete 
 x-Landtagspräsiden ( ) lemma=Ex-Landtagspräsident 
 x-Landwir ( ) lemma=Ex-Landwirt 
 x-Landwirtschaftsministe ( ) lemma=Ex-Landwirtschaftsminister 
 x-Laue-Geländ ( ) lemma=Ex-Laue-Gelände 
 x-Lautere ( ) lemma=Ex-Lautere 
 x-Lebensgefährte ( ) lemma=Ex-Lebensgefährte 
 x-Lehre ( ) lemma=Ex-Lehrer 
 x-Lehreri ( ) lemma=Ex-Lehrerin 
 x-Leibwächte ( ) lemma=Ex-Leibwächter 
 x-Leipzige ( ) lemma=Ex-Leipziger 
 x-Leistungssportleri ( ) lemma=Ex-Leistungssportlerin 
 x-Leite ( ) lemma=Ex-Leiter 
 x-Leiteri ( ) lemma=Ex-Leiterin 
 x-Leningrade ( ) lemma=Ex-Leningrader 
 x-Leutnan ( ) lemma=Ex-Leutnant 
 x-Leverkusene ( ) lemma=Ex-Leverkusener 
 x-Liber ( ) lemma=Ex-Libero 
 x-Liebhabe ( ) lemma=Ex-Liebhaber 
 x-Link ( ) lemma=Ex-Linke 
 x-Linke ( ) lemma=Ex-Linke 
 x-Luftwaffengenera ( ) lemma=Ex-Luftwaffengeneral 
 x-Luftwaffeninspekteu ( ) lemma=Ex-Luftwaffeninspekteur 
 x-Machthabe ( ) lemma=Ex-Machthaber 
 x-Mafios ( ) lemma=Ex-Mafioso 
 x-Mailände ( ) lemma=Ex-Mailänder 
 x-Majo ( ) lemma=Ex-Major 
 x-Makle ( ) lemma=Ex-Makler 
 x-Managemen ( ) lemma=Ex-Management 
 x-Manage ( ) lemma=Ex-Manager 
 x-Manager ( ) lemma=Ex-Manager 
 x-Man ( ) lemma=Ex-Mann 
 x-Mannheime ( ) lemma=Ex-Mannheimer 
 x-Marketingleite ( ) lemma=Ex-Marketingleiter 
 x-Marlboro-Man ( ) lemma=Ex-Marlboro-Mann 
 x-Marschall ( ) lemma=Ex-Marschall 
 x-Maue ( ) lemma=Ex-Mauer 
 x-Md ( ) lemma=Ex-MdL 
 x-Medienministe ( ) lemma=Ex-Medienminister 
 x-Medienreferen ( ) lemma=Ex-Medienreferent 
 x-Medienreferente ( ) lemma=Ex-Medienreferent 
 x-Meiste ( ) lemma=Ex-Meister 
 x-Meisteri ( ) lemma=Ex-Meisterin 
 x-Meister ( ) lemma=Ex-Meister 
 x-Meisterschaftsaspiran ( ) lemma=Ex-Meisterschaftsaspirant 
 x-Mercedes-Statthalte ( ) lemma=Ex-Mercedes-Statthalter 
 x-Messdiene ( ) lemma=Ex-Messdiener 
 x-Messun ( ) lemma=Ex-Messung 
 x-Meßdiene ( ) lemma=Ex-Meßdiener 
 x-MfS-Oberstleutnan ( ) lemma=Ex-MfS-Oberstleutnant 
 x-MfS-Offizie ( ) lemma=Ex-MfS-Offizier 
 x-Miete ( ) lemma=Ex-Mieter 
 x-Militante ( ) lemma=Ex-Militante 
 x-Militä ( ) lemma=Ex-Militär 
 x-Militärherrsche ( ) lemma=Ex-Militärherrscher 
 x-Militärmachthabe ( ) lemma=Ex-Militärmachthaber 
 x-Militär ( ) lemma=Ex-Militär 
 x-Milizionä ( ) lemma=Ex-Milizionär 
 x-Ministe ( ) lemma=Ex-Minister 
 x-Ministeri ( ) lemma=Ex-Ministerin 
 x-Ministeriu ( ) lemma=Ex-Ministerium 
 x-Ministerium ( ) lemma=Ex-Ministerium 
 x-Minister ( ) lemma=Ex-Minister 
 x-Ministerpräsiden ( ) lemma=Ex-Ministerpräsident 
 x-Ministerpräsidente ( ) lemma=Ex-Ministerpräsident 
 x-Mis ( ) lemma=Ex-Miss 
 x-Mitarbeite ( ) lemma=Ex-Mitarbeiter 
 x-Mitarbeiteri ( ) lemma=Ex-Mitarbeiterin 
 x-Mitbegründeri ( ) lemma=Ex-Mitbegründerin 
 x-Mitglie ( ) lemma=Ex-Mitglied 
 x-Mitgliede ( ) lemma=Ex-Mitglied 
 x-Mitglieder ( ) lemma=Ex-Mitglied 
 x-Mittelfeldregisseu ( ) lemma=Ex-Mittelfeldregisseur 
 x-Mi ( ) lemma=Ex-Miss 
 x-Mode ( ) lemma=Ex-Model 
 x-Moderato ( ) lemma=Ex-Moderator 
 x-Monarc ( ) lemma=Ex-Monarch 
 x-Monarche ( ) lemma=Ex-Monarch 
 x-Mossad-Agen ( ) lemma=Ex-Mossad-Agent 
 x-Mönc ( ) lemma=Ex-Mönch 
 x-Münchne ( ) lemma=Ex-Münchner 
 x-NPD-Che ( ) lemma=Ex-NPD-Chef 
 x-NPD-Kreische ( ) lemma=Ex-NPD-Kreischef 
 x-NPD-Man ( ) lemma=Ex-NPD-Mann 
 x-NV ( ) lemma=Ex-NVA 
 x-NVA ( ) lemma=Ex-NVA- 
 x-NVA-Offizie ( ) lemma=Ex-NVA-Offizier 
 x-NVA-Pilo ( ) lemma=Ex-NVA-Pilot 
 x-NVA-Pilote ( ) lemma=Ex-NVA-Pilot 
 x-NVA-Soldate ( ) lemma=Ex-NVA-Soldat 
 x-Nachbar ( ) lemma=Ex-Nachbar 
 x-Nationalgardiste ( ) lemma=Ex-Nationalgardist 
 x-Nationalkeepe ( ) lemma=Ex-Nationalkeeper 
 x-Nationalspiele ( ) lemma=Ex-Nationalspieler 
 x-Nationalspieleri ( ) lemma=Ex-Nationalspielerin 
 x-Nationalspielerinne ( ) lemma=Ex-Nationalspielerin 
 x-Nationalspieler ( ) lemma=Ex-Nationalspieler 
 x-Nationalstürme ( ) lemma=Ex-Nationalstürmer 
 x-Nationaltorhüte ( ) lemma=Ex-Nationaltorhüter 
 x-Nationaltorhüteri ( ) lemma=Ex-Nationaltorhüterin 
 x-Nationaltorwar ( ) lemma=Ex-Nationaltorwart 
 x-Nationaltraine ( ) lemma=Ex-Nationaltrainer 
 x-Nato-Genera ( ) lemma=Ex-Nato-General 
 x-Nato-Oberbefehlshabe ( ) lemma=Ex-Nato-Oberbefehlshaber 
 x-Naz ( ) lemma=Ex-Nazi 
 x-Nazi ( ) lemma=Ex-Nazi 
 x-Neu ( ) lemma=Ex-Neue 
 x-Nixdorf-Vertriebsche ( ) lemma=Ex-Nixdorf-Vertriebschef 
 x-Nomenklatur ( ) lemma=Ex-Nomenklatur 
 x-Nürnberge ( ) lemma=Ex-Nürnberger 
 x-O ( ) lemma=Ex-OB 
 x-Obdachlose ( ) lemma=Ex-Obdachlose 
 x-Oberbürgermeiste ( ) lemma=Ex-Oberbürgermeister 
 x-Oberbürgermeister ( ) lemma=Ex-Oberbürgermeister 
 x-Oberleutnan ( ) lemma=Ex-Oberleutnant 
 x-Oberliga-Fussballe ( ) lemma=Ex-Oberliga-Fußballer 
 x-Oberliga-Fußballe ( ) lemma=Ex-Oberliga-Fußballer 
 x-Oberligaspiele ( ) lemma=Ex-Oberligaspieler 
 x-Oberrichte ( ) lemma=Ex-Oberrichter 
 x-Oberschulra ( ) lemma=Ex-Oberschulrat 
 x-Obers ( ) lemma=Ex-Oberst 
 x-Oberste ( ) lemma=Ex-Oberst 
 x-Oberstleutnan ( ) lemma=Ex-Oberstleutnant 
 x-Oberstudienra ( ) lemma=Ex-Oberstudienrat 
 x-Offenbache ( ) lemma=Ex-Offenbacher 
 x-Offenbacheri ( ) lemma=Ex-Offenbacherin 
 x-Offizie ( ) lemma=Ex-Offizier 
 x-Offizier ( ) lemma=Ex-Offizier 
 x-Olympia-Manage ( ) lemma=Ex-Olympia-Manager 
 x-Olympiasiege ( ) lemma=Ex-Olympiasieger 
 x-Olympionik ( ) lemma=Ex-Olympionike 
 x-Opel-Manage ( ) lemma=Ex-Opel-Manager 
 x-Oppositionell ( ) lemma=Ex-Oppositionelle 
 x-Oppositionelle ( ) lemma=Ex-Oppositionelle 
 x-Ortsvorstehe ( ) lemma=Ex-Ortsvorsteher 
 x-Ostberline ( ) lemma=Ex-Ostberliner 
 x-Ostbloc ( ) lemma=Ex-Ostblock 
 x-Ostblock ( ) lemma=Ex-Ostblock 
 x-Oste ( ) lemma=Ex-Osten 
 x-Ox-Tox-Gefahre ( ) lemma=Ex-Ox-Tox-Gefahr 
 x-PDS-Vizeche ( ) lemma=Ex-PDS-Vizechef 
 x-Paderborne ( ) lemma=Ex-Paderborner 
 x-Parlamentarie ( ) lemma=Ex-Parlamentarier 
 x-Parlamentarieri ( ) lemma=Ex-Parlamentarierin 
 x-Parlamentarier ( ) lemma=Ex-Parlamentarier 
 x-Parlamentspräsiden ( ) lemma=Ex-Parlamentspräsident 
 x-Parlamentspräsidente ( ) lemma=Ex-Parlamentspräsident 
 x-Parlamentspräsidenti ( ) lemma=Ex-Parlamentspräsidentin 
 x-Partei ( ) lemma=Ex-Partei- 
 x-Parteiche ( ) lemma=Ex-Parteichef 
 x-Parteichef ( ) lemma=Ex-Parteichef 
 x-Parteifreun ( ) lemma=Ex-Parteifreund 
 x-Parteiführe ( ) lemma=Ex-Parteiführer 
 x-Parteivorsitzend ( ) lemma=Ex-Parteivorsitzende 
 x-Parteivorsitzende ( ) lemma=Ex-Parteivorsitzende 
 x-Partne ( ) lemma=Ex-Partner 
 x-Partneri ( ) lemma=Ex-Partnerin 
 x-Partner ( ) lemma=Ex-Partner 
 x-Pfarre ( ) lemma=Ex-Pfarrer 
 x-Phanto ( ) lemma=Ex-Phantom 
 x-Pilo ( ) lemma=Ex-Pilot 
 x-Pionier ( ) lemma=Ex-Pionier 
 x-Politbüromitglie ( ) lemma=Ex-Politbüromitglied 
 x-Politbüromitgliede ( ) lemma=Ex-Politbüromitglied 
 x-Politbüromitglied ( ) lemma=Ex-Politbüromitglied 
 x-Politike ( ) lemma=Ex-Politiker 
 x-Politiker ( ) lemma=Ex-Politiker 
 x-Polizeiche ( ) lemma=Ex-Polizeichef 
 x-Polizeipräsiden ( ) lemma=Ex-Polizeipräsident 
 x-Polizis ( ) lemma=Ex-Polizist 
 x-Poliziste ( ) lemma=Ex-Polizist 
 x-Ponyho ( ) lemma=Ex-Ponyhof 
 x-Postle ( ) lemma=Ex-Postler 
 x-Postministe ( ) lemma=Ex-Postminister 
 x-Premie ( ) lemma=Ex-Premier 
 x-Premierministe ( ) lemma=Ex-Premierminister 
 x-Premierministeri ( ) lemma=Ex-Premierministerin 
 x-Premierminister ( ) lemma=Ex-Premierminister 
 x-Premier ( ) lemma=Ex-Premier 
 x-Pressespreche ( ) lemma=Ex-Pressesprecher 
 x-Pressesprecheri ( ) lemma=Ex-Pressesprecherin 
 x-Pressesprecher ( ) lemma=Ex-Pressesprecher 
 x-Preussag ( ) lemma=Ex-Preussag- 
 x-Prieste ( ) lemma=Ex-Priester 
 x-Prin ( ) lemma=Ex-Prinz 
 x-Prinzessi ( ) lemma=Ex-Prinzessin 
 x-Prof ( ) lemma=Ex-Profi 
 x-Profi ( ) lemma=Ex-Profi 
 x-Programmdirekto ( ) lemma=Ex-Programmdirektor 
 x-Prostituiert ( ) lemma=Ex-Prostituierte 
 x-Prostituierte ( ) lemma=Ex-Prostituierte 
 x-Protestanti ( ) lemma=Ex-Protestantin 
 x-Präfek ( ) lemma=Ex-Präfekt 
 x-Präsiden ( ) lemma=Ex-Präsident 
 x-Präsidente ( ) lemma=Ex-Präsident 
 x-Präsidenti ( ) lemma=Ex-Präsidentin 
 x-Präsidentschaftskandida ( ) lemma=Ex-Präsidentschaftskandidat 
 x-Psychiatri ( ) lemma=Ex-Psychiatrie 
 x-Pun ( ) lemma=Ex-Punk 
 x-Punk ( ) lemma=Ex-Punk 
 x-Putschis ( ) lemma=Ex-Putschist 
 x-Putschiste ( ) lemma=Ex-Putschist 
 x-Putzfra ( ) lemma=Ex-Putzfrau 
 x-RA ( ) lemma=Ex-RAF 
 x-RAF ( ) lemma=Ex-RAF- 
 x-RAF-Anwal ( ) lemma=Ex-RAF-Anwalt 
 x-RAF-Fra ( ) lemma=Ex-RAF-Frau 
 x-RAF-Mitglie ( ) lemma=Ex-RAF-Mitglied 
 x-RAF-Mitgliede ( ) lemma=Ex-RAF-Mitglied 
 x-RAF-Terroriste ( ) lemma=Ex-RAF-Terrorist 
 x-REP-Che ( ) lemma=Ex-REP-Chef 
 x-REP-Funktionär ( ) lemma=Ex-REP-Funktionär 
 x-RG ( ) lemma=Ex-RGW 
 x-Rathausche ( ) lemma=Ex-Rathauschef 
 x-Rauche ( ) lemma=Ex-Raucher 
 x-Realsozialiste ( ) lemma=Ex-Realsozialist 
 x-Rebelle ( ) lemma=Ex-Rebell 
 x-Rebellenführe ( ) lemma=Ex-Rebellenführer 
 x-Rechtsanwal ( ) lemma=Ex-Rechtsanwalt 
 x-Redakteu ( ) lemma=Ex-Redakteur 
 x-Redakteur ( ) lemma=Ex-Redakteur 
 x-Referen ( ) lemma=Ex-Referent 
 x-Reformkommuniste ( ) lemma=Ex-Reformkommunist 
 x-Regensburge ( ) lemma=Ex-Regensburger 
 x-Regierend ( ) lemma=Ex-Regierende 
 x-Regierende ( ) lemma=Ex-Regierende 
 x-Regierun ( ) lemma=Ex-Regierung 
 x-Regierungsbeamte ( ) lemma=Ex-Regierungsbeamte 
 x-Regierungsbevollmächtigte ( ) lemma=Ex-Regierungsbevollmächtigte 
 x-Regierungsche ( ) lemma=Ex-Regierungschef 
 x-Regierungschefi ( ) lemma=Ex-Regierungschefin 
 x-Regierungschef ( ) lemma=Ex-Regierungschef 
 x-Regierungsmitgliede ( ) lemma=Ex-Regierungsmitglied 
 x-Regierungsparte ( ) lemma=Ex-Regierungspartei 
 x-Regierungspräsiden ( ) lemma=Ex-Regierungspräsident 
 x-Regierungsspitz ( ) lemma=Ex-Regierungsspitze 
 x-Regierungsspreche ( ) lemma=Ex-Regierungssprecher 
 x-Regisseu ( ) lemma=Ex-Regisseur 
 x-Rekto ( ) lemma=Ex-Rektor 
 x-Rektor ( ) lemma=Ex-Rektor 
 x-Rennfahre ( ) lemma=Ex-Rennfahrer 
 x-Rep-Che ( ) lemma=Ex-Rep-Chef 
 x-Republikane ( ) lemma=Ex-Republikaner 
 x-Republikanerche ( ) lemma=Ex-Republikanerchef 
 x-Republike ( ) lemma=Ex-Republik 
 x-Reservis ( ) lemma=Ex-Reservist 
 x-Reserviste ( ) lemma=Ex-Reservist 
 x-Revolutionä ( ) lemma=Ex-Revolutionär 
 x-Revolutionär ( ) lemma=Ex-Revolutionär 
 x-Revoluzze ( ) lemma=Ex-Revoluzzer 
 x-Richte ( ) lemma=Ex-Richter 
 x-Ringkämpfe ( ) lemma=Ex-Ringkämpfer 
 x-Rivale ( ) lemma=Ex-Rivale 
 x-Rosenheime ( ) lemma=Ex-Rosenheimer 
 x-Rostocke ( ) lemma=Ex-Rostocker 
 x-Rumäne ( ) lemma=Ex-Rumäne 
 x-Rumäni ( ) lemma=Ex-Rumänin 
 x-Rüstungsstaatssekretä ( ) lemma=Ex-Rüstungsstaatssekretär 
 x-SE ( ) lemma=Ex-SED 
 x-SED ( ) lemma=Ex-SED- 
 x-SED-Che ( ) lemma=Ex-SED-Chef 
 x-SED-Chef ( ) lemma=Ex-SED-Chef 
 x-SED-Firme ( ) lemma=Ex-SED-Firma 
 x-SED-Funktionär ( ) lemma=Ex-SED-Funktionär 
 x-SED-Innenministe ( ) lemma=Ex-SED-Innenminister 
 x-SED-Mitglie ( ) lemma=Ex-SED-Mitglied 
 x-SED-Mitgliede ( ) lemma=Ex-SED-Mitglied 
 x-SED-Politbüro-Mitglie ( ) lemma=Ex-SED-Politbüro-Mitglied 
 x-SED-Politike ( ) lemma=Ex-SED-Politiker 
 x-SED-Zeitunge ( ) lemma=Ex-SED-Zeitung 
 x-SEL-Che ( ) lemma=Ex-SEL-Chef 
 x-SP ( ) lemma=Ex-SPD 
 x-SPD ( ) lemma=Ex-SPD- 
 x-SPD-Che ( ) lemma=Ex-SPD-Chef 
 x-SPD-Fraktionsche ( ) lemma=Ex-SPD-Fraktionschef 
 x-SPD-Landesvorsitzende ( ) lemma=Ex-SPD-Landesvorsitzende 
 x-SPD-Vorsitzende ( ) lemma=Ex-SPD-Vorsitzende 
 x-SS-Man ( ) lemma=Ex-SS-Mann 
 x-S ( ) lemma=Ex-SU 
 x-Santa-Fu-Che ( ) lemma=Ex-Santa-Fu-Chef 
 x-Sa ( ) lemma=Ex-Sat 
 x-Schachweltmeiste ( ) lemma=Ex-Schachweltmeister 
 x-Scha ( ) lemma=Ex-Schah 
 x-Schatzmeiste ( ) lemma=Ex-Schatzmeister 
 x-Schatzmeister ( ) lemma=Ex-Schatzmeister 
 x-Schauspiele ( ) lemma=Ex-Schauspieler 
 x-Schlagersänge ( ) lemma=Ex-Schlagersänger 
 x-Schlagzeuge ( ) lemma=Ex-Schlagzeuger 
 x-Schulleite ( ) lemma=Ex-Schulleiter 
 x-Schulsenatori ( ) lemma=Ex-Schulsenatorin 
 x-Schulte ( ) lemma=Ex-Schulte 
 x-Schut ( ) lemma=Ex-Schutz 
 x-Schwergewichts-Boxweltmeiste ( ) lemma=Ex-Schwergewichts-Boxweltmeister 
 x-Schwerine ( ) lemma=Ex-Schweriner 
 x-Schwiegerelter ( ) lemma=Ex-Schwiegereltern 
 x-Schwiegersoh ( ) lemma=Ex-Schwiegersohn 
 x-Schwimme ( ) lemma=Ex-Schwimmer 
 x-Schwimmpräsiden ( ) lemma=Ex-Schwimmpräsident 
 x-Schüle ( ) lemma=Ex-Schüler 
 x-Schüler ( ) lemma=Ex-Schüler 
 x-Schützlin ( ) lemma=Ex-Schützling 
 x-Schützling ( ) lemma=Ex-Schützling 
 x-Securitate-Leut ( ) lemma=Ex-Securitate-Leute 
 x-Securitate-Leute ( ) lemma=Ex-Securitate-Leute 
 x-Sekretäri ( ) lemma=Ex-Sekretärin 
 x-Senato ( ) lemma=ex-Senator 
 x-Senatore ( ) lemma=Ex-Senator 
 x-Senatori ( ) lemma=Ex-Senatorin 
 x-Senatorinne ( ) lemma=Ex-Senatorin 
 x-Senator ( ) lemma=Ex-Senator 
 x-Senatsche ( ) lemma=Ex-Senatschef 
 x-Senatsdirekto ( ) lemma=Ex-Senatsdirektor 
 x-Sensore ( ) lemma=Ex-Sensor 
 x-Sergeante ( ) lemma=Ex-Sergeant 
 x-Sicherheitsberate ( ) lemma=Ex-Sicherheitsberater 
 x-Sicherheitsche ( ) lemma=Ex-Sicherheitschef 
 x-Sklave ( ) lemma=Ex-Sklave 
 x-Solda ( ) lemma=Ex-Soldat 
 x-Soldate ( ) lemma=Ex-Soldat 
 x-Sowjet ( ) lemma=Ex-Sowjet 
 x-Sowjet-Präsiden ( ) lemma=Ex-Sowjet-Präsident 
 x-Sowjetarme ( ) lemma=Ex-Sowjetarmee 
 x-Sowjetmensche ( ) lemma=Ex-Sowjetmensch 
 x-Sowjetrepubli ( ) lemma=Ex-Sowjetrepublik 
 x-Sowjetrepublike ( ) lemma=Ex-Sowjetrepublik 
 x-Sowjetunio ( ) lemma=Ex-Sowjetunion 
 x-Soz ( ) lemma=Ex-Sozi 
 x-Sozialdemokra ( ) lemma=Ex-Sozialdemokrat 
 x-Sozialdemokrati ( ) lemma=Ex-Sozialdemokratin 
 x-Sozialdezernen ( ) lemma=Ex-Sozialdezernent 
 x-Sozialministe ( ) lemma=Ex-Sozialminister 
 x-Sozialministeri ( ) lemma=Ex-Sozialministerin 
 x-Sozialsenato ( ) lemma=Ex-Sozialsenator 
 x-Sozialsenator ( ) lemma=Ex-Sozialsenator 
 x-Spielbankche ( ) lemma=Ex-Spielbankchef 
 x-Spielbankchef ( ) lemma=Ex-Spielbankchef 
 x-Spiele ( ) lemma=Ex-Spieler 
 x-Spielertraine ( ) lemma=Ex-Spielertrainer 
 x-Spio ( ) lemma=Ex-Spion 
 x-Spionage-Che ( ) lemma=Ex-Spionage-Chef 
 x-Spionageche ( ) lemma=Ex-Spionagechef 
 x-Spion ( ) lemma=Ex-Spion 
 x-Spitze ( ) lemma=Ex-Spitzel 
 x-Spitzenkandida ( ) lemma=Ex-Spitzenkandidat 
 x-Sportreporte ( ) lemma=Ex-Sportreporter 
 x-Spreche ( ) lemma=Ex-Sprecher 
 x-Springreite ( ) lemma=Ex-Springreiter 
 x-St ( ) lemma=Ex-St. 
 x-Staats ( ) lemma=Ex-Staats- 
 x-Staatsanwal ( ) lemma=Ex-Staatsanwalt 
 x-Staatsanwält ( ) lemma=Ex-Staatsanwalt 
 x-Staatsche ( ) lemma=Ex-Staatschef 
 x-Staatschef ( ) lemma=Ex-Staatschef 
 x-Staatskanzleiche ( ) lemma=Ex-Staatskanzleichef 
 x-Staatsministe ( ) lemma=Ex-Staatsminister 
 x-Staatsparte ( ) lemma=Ex-Staatspartei 
 x-Staatspräsiden ( ) lemma=Ex-Staatspräsident 
 x-Staatspräsidente ( ) lemma=Ex-Staatspräsident 
 x-Staatsra ( ) lemma=Ex-Staatsrat 
 x-Staatsratsvorsitzende ( ) lemma=Ex-Staatsratsvorsitzende 
 x-Staatssekretä ( ) lemma=Ex-Staatssekretär 
 x-Staatssekretäri ( ) lemma=Ex-Staatssekretärin 
 x-Staatssekretär ( ) lemma=Ex-Staatssekretär 
 x-Stabsche ( ) lemma=Ex-Stabschef 
 x-Stadtche ( ) lemma=Ex-Stadtchef 
 x-Stadtkämmere ( ) lemma=Ex-Stadtkämmerer 
 x-Stadtra ( ) lemma=Ex-Stadtrat 
 x-Stadtrat ( ) lemma=Ex-Stadtrat 
 x-Stadträt ( ) lemma=Ex-Stadtrat 
 x-Stadträti ( ) lemma=Ex-Stadträtin 
 x-Stadtverordnete ( ) lemma=Ex-Stadtverordnete 
 x-Stadtverordnetenvorstehe ( ) lemma=Ex-Stadtverordnetenvorsteher 
 x-Sta ( ) lemma=Ex-Star 
 x-Star ( ) lemma=Ex-Star 
 x-Stas ( ) lemma=Ex-Stasi 
 x-Stasi ( ) lemma=Ex-Stasi- 
 x-Stasi-Adresse ( ) lemma=Ex-Stasi-Adresse 
 x-Stasi-Angehörig ( ) lemma=Ex-Stasi-Angehörige 
 x-Stasi-Che ( ) lemma=Ex-Stasi-Chef 
 x-Stasi-Geländ ( ) lemma=Ex-Stasi-Gelände 
 x-Stasi-Generalmajo ( ) lemma=Ex-Stasi-Generalmajor 
 x-Stasi-Generäl ( ) lemma=Ex-Stasi-General 
 x-Stasi-Knas ( ) lemma=Ex-Stasi-Knast 
 x-Stasi-Leut ( ) lemma=Ex-Stasi-Leute 
 x-Stasi-Leute ( ) lemma=Ex-Stasi-Leute 
 x-Stasi-Majo ( ) lemma=Ex-Stasi-Major 
 x-Stasi-Man ( ) lemma=Ex-Stasi-Mann 
 x-Stasi-Ministe ( ) lemma=Ex-Stasi-Minister 
 x-Stasi-Mitarbeite ( ) lemma=Ex-Stasi-Mitarbeiter 
 x-Stasi-Mitarbeiter ( ) lemma=Ex-Stasi-Mitarbeiter 
 x-Stasi-Obers ( ) lemma=Ex-Stasi-Oberst 
 x-Stasi-Oberstleutnan ( ) lemma=Ex-Stasi-Oberstleutnant 
 x-Stasi-Offizie ( ) lemma=Ex-Stasi-Offizier 
 x-Stasi-Offizier ( ) lemma=Ex-Stasi-Offizier 
 x-Stasi-Offiziere ( ) lemma=Ex-Stasi-Offizier 
 x-Stasi-Spitze ( ) lemma=Ex-Stasi-Spitzel 
 x-Stasi-Vill ( ) lemma=Ex-Stasi-Villa 
 x-Stasi-Zentral ( ) lemma=Ex-Stasi-Zentrale 
 x-Stellvertrete ( ) lemma=Ex-Stellvertreter 
 x-Stellvertreter ( ) lemma=Ex-Stellvertreter 
 x-Sternreporte ( ) lemma=Ex-Sternreporter 
 x-Stipendia ( ) lemma=Ex-Stipendiat 
 x-Stipendiate ( ) lemma=Ex-Stipendiat 
 x-Strassenbahndepo ( ) lemma=Ex-Straßenbahndepot 
 x-Straßenbahndepo ( ) lemma=Ex-Straßenbahndepot 
 x-Studen ( ) lemma=Ex-Student 
 x-Studente ( ) lemma=Ex-Student 
 x-Studentenführe ( ) lemma=Ex-Studentenführer 
 x-Stuttgarte ( ) lemma=Ex-Stuttgarter 
 x-Subkulturell ( ) lemma=Ex-Subkulturelle 
 x-Sulzbache ( ) lemma=Ex-Sulzbacher 
 x-Superministe ( ) lemma=Ex-Superminister 
 x-Sänge ( ) lemma=Ex-Sänger 
 x-Südmilch-Che ( ) lemma=Ex-Südmilch-Chef 
 x-Tagesthemen-Moderato ( ) lemma=Ex-Tagesthemen-Moderator 
 x-Tankstell ( ) lemma=Ex-Tankstelle 
 x-Teamche ( ) lemma=Ex-Teamchef 
 x-Teenie-Sta ( ) lemma=Ex-Teenie-Star 
 x-Teilnehmerinne ( ) lemma=Ex-Teilnehmerin 
 x-Terroris ( ) lemma=Ex-Terrorist 
 x-Terroriste ( ) lemma=Ex-Terrorist 
 x-Terroristi ( ) lemma=Ex-Terroristin 
 x-Thüringer ( ) lemma=Ex-Thüringer 
 x-Torjäge ( ) lemma=Ex-Torjäger 
 x-Tornad ( ) lemma=Ex-Tornado 
 x-Torwar ( ) lemma=Ex-Torwart 
 x-Totalverweigere ( ) lemma=Ex-Totalverweigerer 
 x-Toto-Sänge ( ) lemma=Ex-Toto-Sänger 
 x-Tourismusministe ( ) lemma=Ex-Tourismusminister 
 x-Traine ( ) lemma=Ex-Trainer 
 x-Treuhand-Aufsichtsra ( ) lemma=Ex-Treuhand-Aufsichtsrat 
 x-Treuhand-Manage ( ) lemma=Ex-Treuhand-Manager 
 x-Trinke ( ) lemma=Ex-Trinker 
 x-Tschechoslowake ( ) lemma=Ex-Tschechoslowakei 
 x-Turneri ( ) lemma=Ex-Turnerin 
 x-Tänzeri ( ) lemma=Ex-Tänzerin 
 x-Türk ( ) lemma=Ex-Türke 
 x-Türstehe ( ) lemma=Ex-Türsteher 
 x-US ( ) lemma=Ex-US- 
 x-US-Aussenministe ( ) lemma=Ex-US-Außenminister 
 x-US-Außenministe ( ) lemma=Ex-US-Außenminister 
 x-US-Kasern ( ) lemma=Ex-US-Kaserne 
 x-US-Präsiden ( ) lemma=Ex-US-Präsident 
 x-US-Präsidente ( ) lemma=Ex-US-Präsident 
 x-UdSSR ( ) lemma=Ex-UdSSR- 
 x-Umweltministe ( ) lemma=Ex-Umweltminister 
 x-Umweltministeri ( ) lemma=Ex-Umweltministerin 
 x-Umweltsenato ( ) lemma=Ex-Umweltsenator 
 x-Umweltsenatori ( ) lemma=Ex-Umweltsenatorin 
 x-Unterhaltungsche ( ) lemma=Ex-Unterhaltungschef 
 x-Unterhändle ( ) lemma=Ex-Unterhändler 
 x-Unternehme ( ) lemma=Ex-Unternehmer 
 x-Untersuchungsrichter ( ) lemma=Ex-Untersuchungsrichter 
 x-Urlauberköpfe ( ) lemma=Ex-Urlauberkopf 
 x-V-Man ( ) lemma=Ex-V-Mann 
 x-V-Manne ( ) lemma=Ex-V-Mann 
 x-VW-Che ( ) lemma=Ex-VW-Chef 
 x-Verbündete ( ) lemma=Ex-Verbündete 
 x-Verei ( ) lemma=Ex-Verein 
 x-Verfassungsrichte ( ) lemma=Ex-Verfassungsrichter 
 x-Verfassungsschutzche ( ) lemma=Ex-Verfassungsschutzchef 
 x-Verfassungsschütze ( ) lemma=Ex-Verfassungsschützer 
 x-Verkehrsministe ( ) lemma=Ex-Verkehrsminister 
 x-Verkehrssenato ( ) lemma=Ex-Verkehrssenator 
 x-Verlagsagen ( ) lemma=Ex-Verlagsagent 
 x-Verlege ( ) lemma=Ex-Verleger 
 x-Verlobte ( ) lemma=Ex-Verlobte 
 x-Verteidige ( ) lemma=Ex-Verteidiger 
 x-Verteidigungsministe ( ) lemma=Ex-Verteidigungsminister 
 x-Verteidigungsminister ( ) lemma=Ex-Verteidigungsminister 
 x-Vertragsarbeite ( ) lemma=Ex-Vertragsarbeiter 
 x-Vertragsarbeiter ( ) lemma=Ex-Vertragsarbeiter 
 x-Verwaltungsangestellte ( ) lemma=Ex-Verwaltungsangestellter 
 x-Verwaltungsche ( ) lemma=Ex-Verwaltungschef 
 x-Verwaltungsdirekto ( ) lemma=Ex-Verwaltungsdirektor 
 x-Vizepräsiden ( ) lemma=Ex-Vizepräsident 
 x-Vizepräsidente ( ) lemma=Ex-Vizepräsident 
 x-Vizepräsidenti ( ) lemma=Ex-Vizepräsidentin 
 x-Volkskammerabgeordnet ( ) lemma=Ex-Volkskammerabgeordnete 
 x-Volkskammerabgeordnete ( ) lemma=Ex-Volkskammerabgeordnete 
 x-Volkskammerpräsiden ( ) lemma=Ex-Volkskammerpräsident 
 x-Volkspolizis ( ) lemma=Ex-Volkspolizist 
 x-Volkspoliziste ( ) lemma=Ex-Volkspolizist 
 x-Vorsitzend ( ) lemma=Ex-Vorsitzende 
 x-Vorsitzende ( ) lemma=Ex-Vorsitzende 
 x-Vorstan ( ) lemma=Ex-Vorstand 
 x-Vorstand ( ) lemma=Ex-Vorstand 
 x-Vorstandsche ( ) lemma=Ex-Vorstandschef 
 x-Vorstandsmitglie ( ) lemma=Ex-Vorstandsmitglied 
 x-Vorstandssekretä ( ) lemma=Ex-Vorstandssekretär 
 x-Vorstandssekretär ( ) lemma=Ex-Vorstandssekretär 
 x-Vorstandsspreche ( ) lemma=Ex-Vorstandssprecher 
 x-Vorstandsvorsitzende ( ) lemma=Ex-Vorstandsvorsitzende 
 x-Vorständ ( ) lemma=Ex-Vorstand 
 x-WDR-Intendan ( ) lemma=Ex-WDR-Intendant 
 x-Wachman ( ) lemma=Ex-Wachmann 
 x-Waffen-SS-Man ( ) lemma=Ex-Waffen-SS-Mann 
 x-Wahlkampfmanage ( ) lemma=Ex-Wahlkampfmanager 
 x-Waldhöfe ( ) lemma=Ex-Waldhöfer 
 x-Wallaue ( ) lemma=Ex-Wallauer 
 x-Wallauer ( ) lemma=Ex-Wallauern 
 x-Walldorfe ( ) lemma=Ex-Walldorfer 
 x-Weltmeiste ( ) lemma=Ex-Weltmeister 
 x-Weltmeisteri ( ) lemma=Ex-Weltmeisterin 
 x-Weltmeister ( ) lemma=Ex-Weltmeister 
 x-Westberline ( ) lemma=Ex-Westberliner 
 x-Wiesbadene ( ) lemma=Ex-Wiesbadener 
 x-Wiesbadeneri ( ) lemma=Ex-Wiesbadenerin 
 x-Wir ( ) lemma=Ex-Wirt 
 x-Wirti ( ) lemma=Ex-Wirtin 
 x-Wirtschaftsministe ( ) lemma=Ex-Wirtschaftsminister 
 x-Wirtschaftssenato ( ) lemma=Ex-Wirtschaftssenator 
 x-Wissenschaftssenato ( ) lemma=Ex-Wissenschaftssenator 
 x-Wohnungsbauministe ( ) lemma=Ex-Wohnungsbauminister 
 x-Wunderkin ( ) lemma=Ex-Wunderkind 
 x-ZD ( ) lemma=Ex-ZDF 
 x-ZK-Mitglie ( ) lemma=Ex-ZK-Mitglied 
 x-Zentralbankche ( ) lemma=Ex-Zentralbankchef 
 x-Zuhälte ( ) lemma=Ex-Zuhälter 
 x-Zwangsarbeite ( ) lemma=Ex-Zwangsarbeiter 
 x-Zöglin ( ) lemma=Ex-Zögling 
 x-coop-Che ( ) lemma=Ex-coop-Chef 
 x-jugoslawisch ( ) lemma=ex-jugoslawisch 
 x-kommunistische ( ) lemma=ex-kommunistisch 
 x-taz-Journaliste ( ) lemma=Ex-taz-Journalist 
 x-taz-Kolleg ( ) lemma=Ex-taz-Kollege 
 x-taz-Mitarbeite ( ) lemma=Ex-taz-Mitarbeiter 
 x-taz-Redakteu ( ) lemma=Ex-taz-Redakteur 
 x-und ( ) lemma=Ex-und- 
 x-und-Hopp ( ) lemma=Ex-und-Hopp- 
 x-und-hopp-Gefäs ( ) lemma=Ex-und-hopp-Gefäß 
 x-und-hopp-Gefä ( ) lemma=Ex-und-hopp-Gefäß 
 x-und-hopp-Mentalitä ( ) lemma=Ex-und-hopp-Mentalität 
 x-und-hopp-Wegwerf-Generatio ( ) lemma=Ex-und-hopp-Wegwerf-Generation 
 xakt ( ) lemma=exakt 
 xakte ( ) lemma=exakt 
 xakthei ( ) lemma=Exaktheit 
 xaltatio ( ) lemma=Exaltation 
 xaltatione ( ) lemma=Exaltation 
 xaltiert ( ) lemma=exaltiert 
 xame ( ) lemma=Examen 
 xamengebühre ( ) lemma=Examengebühr 
 xamen ( ) lemma=Examen 
 xamensabsolvente ( ) lemma=Examensabsolvent 
 xamensangs ( ) lemma=Examensangst 
 xamensarbei ( ) lemma=Examensarbeit 
 xamensarbeite ( ) lemma=Examensarbeit 
 xamensergebnisse ( ) lemma=Examensergebnis 
 xamensgehal ( ) lemma=Examensgehalt 
 xamenskandida ( ) lemma=Examenskandidat 
 xamenskandidate ( ) lemma=Examenskandidat 
 xamensklausu ( ) lemma=Examensklausur 
 xamensnote ( ) lemma=Examensnote 
 xamensphas ( ) lemma=Examensphase 
 xamensprüfunge ( ) lemma=Examensprüfung 
 xamensstres ( ) lemma=Examensstress 
 xamensstre ( ) lemma=Examensstress 
 xamensvorbereitunge ( ) lemma=Examensvorbereitung 
 xamenszahle ( ) lemma=Examenszahl 
 xaminiert ( ) lemma=examiniert 
 xce ( ) lemma=Excel 
 xcelsior-Hochhau ( ) lemma=Excelsior-Hochhaus 
 xclusiv-Intervie ( ) lemma=Exclusiv-Interview 
 xeges ( ) lemma=Exegese 
 xegese ( ) lemma=Exegese 
 xekutiere ( ) lemma=exekutieren 
 xekutierte ( ) lemma=exekutiert 
 xekutio ( ) lemma=Exekution 
 xekutione ( ) lemma=Exekution 
 xekutionsaufschu ( ) lemma=Exekutionsaufschub 
 xekutionsbefeh ( ) lemma=Exekutionsbefehl 
 xekutionsinstrumen ( ) lemma=Exekutionsinstrument 
 xekutionskommand ( ) lemma=Exekutionskommando 
 xekutionskommando ( ) lemma=Exekutionskommando 
 xekutionsmaschin ( ) lemma=Exekutionsmaschine 
 xekutionsopfe ( ) lemma=Exekutionsopfer 
 xekutionsorga ( ) lemma=Exekutionsorgan 
 xekutionsplat ( ) lemma=Exekutionsplatz 
 xekutiv ( ) lemma=exekutiv 
 xekutiv-Ausschus ( ) lemma=Exekutiv-Ausschuss 
 xekutiv-Ausschu ( ) lemma=Exekutiv-Ausschuss 
 xekutiv-Direkto ( ) lemma=Exekutiv-Direktor 
 xekutiv-Komite ( ) lemma=Exekutiv-Komitee 
 xekutiv-Komitee ( ) lemma=Exekutiv-Komitee 
 xekutiv-Orde ( ) lemma=Exekutiv-Order 
 xekutiv-Sekretä ( ) lemma=Exekutiv-Sekretär 
 xekutiv-Sitzun ( ) lemma=Exekutiv-Sitzung 
 xekutivausschus ( ) lemma=Exekutivausschuss 
 xekutivausschusse ( ) lemma=Exekutivausschuss 
 xekutivausschu ( ) lemma=Exekutivausschuss 
 xekutivbeamte ( ) lemma=Exekutivbeamte 
 xekutivbefugniss ( ) lemma=Exekutivbefugnis 
 xekutivbefugnisse ( ) lemma=Exekutivbefugnis 
 xekutivbehörd ( ) lemma=Exekutivbehörde 
 xekutivbür ( ) lemma=Exekutivbüro 
 xekutivbüro ( ) lemma=Exekutivbüro 
 xekutivchef ( ) lemma=Exekutivchef 
 xekutivdirekto ( ) lemma=Exekutivdirektor 
 xekutivdirektore ( ) lemma=Exekutivdirektor 
 xekutivdirektori ( ) lemma=Exekutivdirektorin 
 xekutivdirektoriu ( ) lemma=Exekutivdirektorium 
 xekutivdirektor ( ) lemma=Exekutivdirektor 
 xekutive ( ) lemma=exekutiv 
 xekutiverlas ( ) lemma=Exekutiverlass 
 xekutiverla ( ) lemma=Exekutiverlass 
 xekutivgewal ( ) lemma=Exekutivgewalt 
 xekutivgremie ( ) lemma=Exekutivgremium 
 xekutivgremiu ( ) lemma=Exekutivgremium 
 xekutivkomite ( ) lemma=Exekutivkomitee 
 xekutivkomitee ( ) lemma=Exekutivkomitee 
 xekutivkommissio ( ) lemma=Exekutivkommission 
 xekutivmach ( ) lemma=Exekutivmacht 
 xekutivmitglie ( ) lemma=Exekutivmitglied 
 xekutivmitgliede ( ) lemma=Exekutivmitglied 
 xekutivmitglieder ( ) lemma=Exekutivmitglied 
 xekutivorde ( ) lemma=Exekutivorder 
 xekutivorga ( ) lemma=Exekutivorgan 
 xekutivorgan ( ) lemma=Exekutivorgan 
 xekutivorgane ( ) lemma=Exekutivorgan 
 xekutivpräsiden ( ) lemma=Exekutivpräsident 
 xekutivra ( ) lemma=Exekutivrat 
 xekutivrate ( ) lemma=Exekutivrat 
 xekutivrat ( ) lemma=Exekutivrat 
 xekutivsekretä ( ) lemma=Exekutivsekretär 
 xekutivsitzun ( ) lemma=Exekutivsitzung 
 xekutivvollmachte ( ) lemma=Exekutivvollmacht 
 xekuto ( ) lemma=Exekutor 
 xekutore ( ) lemma=Exekutor 
 xempe ( ) lemma=Exempel 
 xempel ( ) lemma=Exempel 
 xempla ( ) lemma=Exemplar 
 xemplar ( ) lemma=Exemplar 
 xemplare ( ) lemma=Exemplar 
 xemplarisch ( ) lemma=exemplarisch 
 xemplarische ( ) lemma=exemplarisch 
 xerziere ( ) lemma=exerzieren 
 xerzierfel ( ) lemma=Exerzierfeld 
 xerziergeländ ( ) lemma=Exerziergelände 
 xerzierhall ( ) lemma=Exerzierhalle 
 xerzierhau ( ) lemma=Exerzierhaus 
 xerzierhause ( ) lemma=Exerzierhaus 
 xerzierplat ( ) lemma=Exerzierplatz 
 xerzierplatze ( ) lemma=Exerzierplatz 
 xerzierplätz ( ) lemma=Exerzierplatz 
 xerzierreglemen ( ) lemma=Exerzierreglement 
 xerzierritua ( ) lemma=Exerzierritual 
 xerzierschrit ( ) lemma=Exerzierschritt 
 xerzierstrass ( ) lemma=Exerzierstraße 
 xerzierstraß ( ) lemma=Exerzierstraße 
 xerzierübunge ( ) lemma=Exerzierübung 
 xerzitien ( ) lemma=Exerzitien- 
 xguerillero ( ) lemma=Exguerilleros 
 xhibitio ( ) lemma=Exhibition 
 xhibitionismu ( ) lemma=Exhibitionismus 
 xhibitionis ( ) lemma=Exhibitionist 
 xhibitioniste ( ) lemma=Exhibitionist 
 xhibitionisti ( ) lemma=Exhibitionistin 
 xi ( ) lemma=Exil 
 xil ( ) lemma=Exil 
 xil-Afghane ( ) lemma=Exil-Afghane 
 xil-Australie ( ) lemma=Exil-Australier 
 xil-Autore ( ) lemma=Exil-Autor 
 xil-Baske ( ) lemma=Exil-Baske 
 xil-Bayer ( ) lemma=Exil-Bayer 
 xil-Bilde ( ) lemma=Exil-Bild 
 xil-CD ( ) lemma=Exil-CDU 
 xil-Chilen ( ) lemma=Exil-Chilene 
 xil-Chilene ( ) lemma=Exil-Chilene 
 xil-Chinese ( ) lemma=Exil-Chinese 
 xil-Eritree ( ) lemma=Exil-Eritreer 
 xil-Este ( ) lemma=Exil-Este 
 xil-Gedicht ( ) lemma=Exil-Gedicht 
 xil-Gemeind ( ) lemma=Exil-Gemeinde 
 xil-Grupp ( ) lemma=Exil-Gruppe 
 xil-Haitiane ( ) lemma=Exil-Haitianer 
 xil-Irake ( ) lemma=Exil-Iraker 
 xil-Irane ( ) lemma=Exil-Iraner 
 xil-Iraner ( ) lemma=Exil-Iraner 
 xil-K ( ) lemma=Exil-KP 
 xil-Kroate ( ) lemma=Exil-Kroate 
 xil-Kubane ( ) lemma=Exil-Kubaner 
 xil-Kubaner ( ) lemma=Exil-Kubaner 
 xil-Kurde ( ) lemma=Exil-Kurde 
 xil-Lett ( ) lemma=Exil-Lette 
 xil-Lette ( ) lemma=Exil-Lette 
 xil-Oppositio ( ) lemma=Exil-Opposition 
 xil-Organisatio ( ) lemma=Exil-Organisation 
 xil-Palästinense ( ) lemma=Exil-Palästinenser 
 xil-Palästinenser ( ) lemma=Exil-Palästinenser 
 xil-Parlamen ( ) lemma=Exil-Parlament 
 xil-Pole ( ) lemma=Exil-Pole 
 xil-Politike ( ) lemma=Exil-Politiker 
 xil-Präsiden ( ) lemma=Exil-Präsident 
 xil-Präsidente ( ) lemma=Exil-Präsident 
 xil-Regierun ( ) lemma=Exil-Regierung 
 xil-Rumäne ( ) lemma=Exil-Rumäne 
 xil-Russe ( ) lemma=Exil-Russe 
 xil-SP ( ) lemma=Exil-SPD 
 xil-Schriftstelle ( ) lemma=Exil-Schriftsteller 
 xil-Schriftsteller ( ) lemma=Exil-Schriftsteller 
 xil-Schule ( ) lemma=Exil-Schule 
 xil-Serbe ( ) lemma=Exil-Serbe 
 xil-Südafrikane ( ) lemma=Exil-Südafrikaner 
 xil-Tibete ( ) lemma=Exil-Tibeter 
 xil-Ukraine ( ) lemma=Exil-Ukrainer 
 xil-Unga ( ) lemma=Exil-Ungar 
 xil-Vietnamese ( ) lemma=Exil-Vietnamese 
 xilafghane ( ) lemma=Exilafghane 
 xilante ( ) lemma=Exilante 
 xilantengedicht ( ) lemma=Exilantengedicht 
 xilantengrupp ( ) lemma=Exilantengruppe 
 xilantenhei ( ) lemma=Exilantenheim 
 xilarchi ( ) lemma=Exilarchiv 
 xilarchiv ( ) lemma=Exilarchiv 
 xilarme ( ) lemma=Exilarmee 
 xilauto ( ) lemma=Exilautor 
 xilautore ( ) lemma=Exilautor 
 xilbewegun ( ) lemma=Exilbewegung 
 xilbiographi ( ) lemma=Exilbiographie 
 xilchilen ( ) lemma=Exilchilene 
 xilchinese ( ) lemma=Exilchinese 
 xilerfahrun ( ) lemma=Exilerfahrung 
 xile ( ) lemma=Exil 
 xilforsche ( ) lemma=Exilforscher 
 xilforschun ( ) lemma=Exilforschung 
 xilführe ( ) lemma=Exilführer 
 xilführun ( ) lemma=Exilführung 
 xilgemeind ( ) lemma=Exilgemeinde 
 xilgemeinde ( ) lemma=Exilgemeinde 
 xilgrupp ( ) lemma=Exilgruppe 
 xilgruppe ( ) lemma=Exilgruppe 
 xilhaitiane ( ) lemma=Exilhaitianer 
 xilhaitianer ( ) lemma=Exilhaitianer 
 xilheima ( ) lemma=Exilheimat 
 xiliert ( ) lemma=exiliert 
 xilierte ( ) lemma=exiliert 
 xilirake ( ) lemma=Exiliraker 
 xiliraker ( ) lemma=Exiliraker 
 xilirane ( ) lemma=Exiliraner 
 xiliraner ( ) lemma=Exiliraner 
 xiljahr ( ) lemma=Exiljahr 
 xiljahre ( ) lemma=Exiljahr 
 xilkoreane ( ) lemma=Exilkoreaner 
 xilkoreaner ( ) lemma=Exilkoreaner 
 xilkreis ( ) lemma=Exilkreis 
 xilkreise ( ) lemma=Exilkreis 
 xilkroate ( ) lemma=Exilkroate 
 xilkubane ( ) lemma=Exilkubaner 
 xilkubaner ( ) lemma=Exilkubaner 
 xilkurde ( ) lemma=Exilkurde 
 xilkuwaiter ( ) lemma=Exilkuwaiter 
 xilköni ( ) lemma=Exilkönig 
 xillan ( ) lemma=Exilland 
 xillande ( ) lemma=Exilland 
 xillebe ( ) lemma=Exilleben 
 xillette ( ) lemma=Exillette 
 xilliteratu ( ) lemma=Exilliteratur 
 xillände ( ) lemma=Exilland 
 xilministe ( ) lemma=Exilminister 
 xilnicaraguane ( ) lemma=Exilnicaraguaner 
 xilnicaraguaner ( ) lemma=Exilnicaraguaner 
 xiloppositio ( ) lemma=Exilopposition 
 xilorganisatio ( ) lemma=Exilorganisation 
 xilorganisatione ( ) lemma=Exilorganisation 
 xilor ( ) lemma=Exilort 
 xilpalästinense ( ) lemma=Exilpalästinenser 
 xilpalästinenser ( ) lemma=Exilpalästinenser 
 xilpaps ( ) lemma=Exilpapst 
 xilparlamen ( ) lemma=Exilparlament 
 xilparlament ( ) lemma=Exilparlament 
 xilparte ( ) lemma=Exilpartei 
 xilparteie ( ) lemma=Exilpartei 
 xilpol ( ) lemma=Exilpole 
 xilpole ( ) lemma=Exilpole 
 xilpolitike ( ) lemma=Exilpolitiker 
 xilpolitiker ( ) lemma=Exilpolitiker 
 xilpress ( ) lemma=Exilpresse 
 xilpräsiden ( ) lemma=Exilpräsident 
 xilpräsidente ( ) lemma=Exilpräsident 
 xilregierun ( ) lemma=Exilregierung 
 xilregierunge ( ) lemma=Exilregierung 
 xilroma ( ) lemma=Exilroman 
 xilruande ( ) lemma=Exilruander 
 xilrumän ( ) lemma=Exilrumäne 
 xilrumäne ( ) lemma=Exilrumäne 
 xilrundfun ( ) lemma=Exilrundfunk 
 xilruss ( ) lemma=Exilrusse 
 xilrusse ( ) lemma=Exilrusse 
 xilschriftstelle ( ) lemma=Exilschriftsteller 
 xilschriftstelleri ( ) lemma=Exilschriftstellerin 
 xilschriftsteller ( ) lemma=Exilschriftsteller 
 xilschul ( ) lemma=Exilschule 
 xilschule ( ) lemma=Exilschule 
 xilschwabe ( ) lemma=Exilschwabe 
 xilschwäbi ( ) lemma=Exilschwäbin 
 xilsena ( ) lemma=Exilsenat 
 xilsituatio ( ) lemma=Exilsituation 
 xilstaa ( ) lemma=Exilstaat 
 xilstatione ( ) lemma=Exilstation 
 xilstudente ( ) lemma=Exilstudent 
 xilsuchende ( ) lemma=Exilsuchende 
 xiltibete ( ) lemma=Exiltibeter 
 xiltibeter ( ) lemma=Exiltibeter 
 xiltschech ( ) lemma=Exiltscheche 
 xiltscheche ( ) lemma=Exiltscheche 
 xiltürke ( ) lemma=Exiltürke 
 xilukraine ( ) lemma=Exilukrainer 
 xilunga ( ) lemma=Exilungar 
 xilungar ( ) lemma=Exilungar 
 xilverla ( ) lemma=Exilverlag 
 xilverwaltun ( ) lemma=Exilverwaltung 
 xilvietnamese ( ) lemma=Exilvietnamese 
 xilwer ( ) lemma=Exilwerk 
 xilzei ( ) lemma=Exilzeit 
 xilzeitschrif ( ) lemma=Exilzeitschrift 
 xilzeitun ( ) lemma=Exilzeitung 
 xilzeitunge ( ) lemma=Exilzeitung 
 ximer-Lase ( ) lemma=Eximer-Laser 
 xistentialismu ( ) lemma=Existentialismus 
 xistentialis ( ) lemma=Existentialist 
 xistentialiste ( ) lemma=Existentialist 
 xistentialphilosophe ( ) lemma=Existentialphilosoph 
 xistentiell ( ) lemma=existentiell 
 xistentielle ( ) lemma=existentiell 
 xisten ( ) lemma=existent 
 xistenz ( ) lemma=Existenz- 
 xistenz-Erlebe ( ) lemma=Existenz-Erleben 
 xistenz-Gründerinne ( ) lemma=Existenz-Gründerin 
 xistenzangs ( ) lemma=Existenzangst 
 xistenzbasi ( ) lemma=Existenzbasis 
 xistenzbedingun ( ) lemma=Existenzbedingung 
 xistenzbedingunge ( ) lemma=Existenzbedingung 
 xistenzbedrohend ( ) lemma=existenzbedrohend 
 xistenzbedrohun ( ) lemma=Existenzbedrohung 
 xistenzbehauptun ( ) lemma=Existenzbehauptung 
 xistenzberechtigun ( ) lemma=Existenzberechtigung 
 xistenzbewei ( ) lemma=Existenzbeweis 
 xistenzdaue ( ) lemma=Existenzdauer 
 xistenzdruc ( ) lemma=Existenzdruck 
 xistenze ( ) lemma=Existenz 
 xistenzfor ( ) lemma=Existenzform 
 xistenzforme ( ) lemma=Existenzform 
 xistenzfrag ( ) lemma=Existenzfrage 
 xistenzfrage ( ) lemma=Existenzfrage 
 xistenzfähigkei ( ) lemma=Existenzfähigkeit 
 xistenzgaranti ( ) lemma=Existenzgarantie 
 xistenzgefah ( ) lemma=Existenzgefahr 
 xistenzgefährdun ( ) lemma=Existenzgefährdung 
 xistenzgefährdunge ( ) lemma=Existenzgefährdung 
 xistenzgel ( ) lemma=Existenzgeld 
 xistenzgrenz ( ) lemma=Existenzgrenze 
 xistenzgrun ( ) lemma=Existenzgrund 
 xistenzgrundlag ( ) lemma=Existenzgrundlage 
 xistenzgrundlage ( ) lemma=Existenzgrundlage 
 xistenzgründe ( ) lemma=Existenzgründer 
 xistenzgründerdarlehe ( ) lemma=Existenzgründerdarlehen 
 xistenzgründeri ( ) lemma=Existenzgründerin 
 xistenzgründerinne ( ) lemma=Existenzgründerin 
 xistenzgründer ( ) lemma=Existenzgründer 
 xistenzgründersemina ( ) lemma=Existenzgründerseminar 
 xistenzgründun ( ) lemma=Existenzgründung 
 xistenzgründunge ( ) lemma=Existenzgründung 
 xistenzgründungs ( ) lemma=Existenzgründungs- 
 xistenzgründungsdarlehe ( ) lemma=Existenzgründungsdarlehen 
 xistenzgründungsförderun ( ) lemma=Existenzgründungsförderung 
 xistenzgründungshilfe ( ) lemma=Existenzgründungshilfe 
 xistenzgründungskredit ( ) lemma=Existenzgründungskredit 
 xistenzgründungskurs ( ) lemma=Existenzgründungskurs 
 xistenzgründungsprogram ( ) lemma=Existenzgründungsprogramm 
 xistenzgründungssemina ( ) lemma=Existenzgründungsseminar 
 xistenzgründungsseminare ( ) lemma=Existenzgründungsseminar 
 xistenziell ( ) lemma=existentiell 
 xistenzielle ( ) lemma=existentiell 
 xistenzkamp ( ) lemma=Existenzkampf 
 xistenzkampfe ( ) lemma=Existenzkampf 
 xistenzkris ( ) lemma=Existenzkrise 
 xistenzkrise ( ) lemma=Existenzkrise 
 xistenzkämpfe ( ) lemma=Existenzkämpfer 
 xistenzminimu ( ) lemma=Existenzminimum 
 xistenzminimum ( ) lemma=Existenzminimum 
 xistenzmöglichkei ( ) lemma=Existenzmöglichkeit 
 xistenzmöglichkeite ( ) lemma=Existenzmöglichkeit 
 xistenzneugründunge ( ) lemma=Existenzneugründung 
 xistenznivea ( ) lemma=Existenzniveau 
 xistenzno ( ) lemma=Existenznot 
 xistenznöt ( ) lemma=Existenznot 
 xistenznöte ( ) lemma=Existenznot 
 xistenzpflich ( ) lemma=Existenzpflicht 
 xistenzphilosophi ( ) lemma=Existenzphilosophie 
 xistenzproble ( ) lemma=Existenzproblem 
 xistenzproblem ( ) lemma=Existenzproblem 
 xistenzprobleme ( ) lemma=Existenzproblem 
 xistenzquell ( ) lemma=Existenzquelle 
 xistenzrech ( ) lemma=Existenzrecht 
 xistenzrecht ( ) lemma=Existenzrecht 
 xistenzrechte ( ) lemma=Existenzrecht 
 xistenzrisik ( ) lemma=Existenzrisiko 
 xistenzschwierigkeite ( ) lemma=Existenzschwierigkeit 
 xistenzsicherun ( ) lemma=Existenzsicherung 
 xistenzsicherungsprogram ( ) lemma=Existenzsicherungsprogramm 
 xistenzsorge ( ) lemma=Existenzsorge 
 xistenzsti ( ) lemma=Existenzstil 
 xistenzunsicherhei ( ) lemma=Existenzunsicherheit 
 xistenzverhältniss ( ) lemma=Existenzverhältnis 
 xistenzvernichtun ( ) lemma=Existenzvernichtung 
 xistenzweis ( ) lemma=Existenzweise 
 xistenzweise ( ) lemma=Existenzweise 
 xistenzängst ( ) lemma=Existenzangst 
 xistenzängste ( ) lemma=Existenzangst 
 xistiere ( ) lemma=existieren 
 xistierend ( ) lemma=existierend 
 xistierende ( ) lemma=existierend 
 xistieren ( ) lemma=existierend 
 xistiert ( ) lemma=existiert 
 xklusio ( ) lemma=Exklusion 
 xklusiv ( ) lemma=exklusiv 
 xklusiv-Informatio ( ) lemma=Exklusiv-Information 
 xklusiv-Intervie ( ) lemma=Exklusiv-Interview 
 xklusiv-Interview ( ) lemma=Exklusiv-Interview 
 xklusiv-Recht ( ) lemma=Exklusiv-Recht 
 xklusiv-Verspreche ( ) lemma=Exklusiv-Versprechen 
 xklusiv-Vertra ( ) lemma=Exklusiv-Vertrag 
 xklusivangebo ( ) lemma=Exklusivangebot 
 xklusivberich ( ) lemma=Exklusivbericht 
 xklusivbericht ( ) lemma=Exklusivbericht 
 xklusive ( ) lemma=exklusiv 
 xklusivgas ( ) lemma=Exklusivgast 
 xklusivgeschicht ( ) lemma=Exklusivgeschichte 
 xklusivintervie ( ) lemma=Exklusivinterview 
 xklusivinterview ( ) lemma=Exklusivinterview 
 xklusivitä ( ) lemma=Exklusivität 
 xklusivitäte ( ) lemma=Exklusivität 
 xklusivlizen ( ) lemma=Exklusivlizenz 
 xklusivmeldun ( ) lemma=Exklusivmeldung 
 xklusivmodel ( ) lemma=Exklusivmodell 
 xklusivprogram ( ) lemma=Exklusivprogramm 
 xklusivrech ( ) lemma=Exklusivrecht 
 xklusivrecht ( ) lemma=Exklusivrecht 
 xklusivst ( ) lemma=exklusiv 
 xklusivstor ( ) lemma=Exklusivstory 
 xklusivvertra ( ) lemma=Exklusivvertrag 
 xklusivverträg ( ) lemma=Exklusivvertrag 
 xkommunikatio ( ) lemma=Exkommunikation 
 xkommunizierun ( ) lemma=Exkommunizierung 
 xkremen ( ) lemma=Exkrement 
 xkrement ( ) lemma=Exkrement 
 xkrementeber ( ) lemma=Exkrementeberg 
 xkremente ( ) lemma=Exkrement 
 xkulpatio ( ) lemma=Exkulpation 
 xkulpationsstrategie ( ) lemma=Exkulpationsstrategie 
 xkur ( ) lemma=Exkurs 
 xkurs ( ) lemma=Exkurs 
 xkurse ( ) lemma=Exkurs 
 xkursio ( ) lemma=Exkursion 
 xkursione ( ) lemma=Exkursion 
 xkursions-Reih ( ) lemma=Exkursions-Reihe 
 xkursionsgruppe ( ) lemma=Exkursionsgruppe 
 xkursionsleite ( ) lemma=Exkursionsleiter 
 xkursionsreih ( ) lemma=Exkursionsreihe 
 xkursionstag ( ) lemma=Exkursionstag 
 xkursionsteilnehme ( ) lemma=Exkursionsteilnehmer 
 xkursionsunfal ( ) lemma=Exkursionsunfall 
 xlibri ( ) lemma=Exlibris 
 xmatrikulatio ( ) lemma=Exmatrikulation 
 xmatrikulatione ( ) lemma=Exmatrikulation 
 xmilizionä ( ) lemma=Exmilizionär 
 xocet-Raket ( ) lemma=Exocet-Rakete 
 xocet-Rakete ( ) lemma=Exocet-Rakete 
 xodu ( ) lemma=Exodus 
 xor-Akti ( ) lemma=Exor-Aktie 
 xor-Aktie ( ) lemma=Exor-Aktie 
 xor-Anteil ( ) lemma=Exor-Anteil 
 xor-Beteiligun ( ) lemma=Exor-Beteiligung 
 xorbitant ( ) lemma=exorbitant 
 xorziere ( ) lemma=exorzieren 
 xorzismus-Totschla ( ) lemma=Exorzismus-Totschlag 
 xorzis ( ) lemma=Exorzist 
 xorziste ( ) lemma=Exorzist 
 xo ( ) lemma=Exot 
 xotarie ( ) lemma=Exotarie 
 xote ( ) lemma=Exot 
 xoten ( ) lemma=Exoten- 
 xotenbonu ( ) lemma=Exotenbonus 
 xotendasei ( ) lemma=Exotendasein 
 xoteneck ( ) lemma=Exotenecke 
 xotenkurs ( ) lemma=Exotenkurs 
 xotenliebhabe ( ) lemma=Exotenliebhaber 
 xotenroll ( ) lemma=Exotenrolle 
 xotenscha ( ) lemma=Exotenschau 
 xotenschwän ( ) lemma=Exotenschwan 
 xotensportar ( ) lemma=Exotensportart 
 xotenwal ( ) lemma=Exotenwald 
 xoti ( ) lemma=Exotin 
 xotika-Sammlunge ( ) lemma=Exotika-Sammlung 
 xotinne ( ) lemma=Exotin 
 xotisch ( ) lemma=exotisch 
 xotische ( ) lemma=exotisch 
 xpandiere ( ) lemma=expandieren 
 xpansio ( ) lemma=Expansion 
 xpansione ( ) lemma=Expansion 
 xpansions ( ) lemma=Expansions- 
 xpansionsabsichte ( ) lemma=Expansionsabsicht 
 xpansionsbestrebunge ( ) lemma=Expansionsbestrebung 
 xpansionschance ( ) lemma=Expansionschance 
 xpansionsdran ( ) lemma=Expansionsdrang 
 xpansionsdrange ( ) lemma=Expansionsdrang 
 xpansionsdruc ( ) lemma=Expansionsdruck 
 xpansionsgebie ( ) lemma=Expansionsgebiet 
 xpansionsgedanke ( ) lemma=Expansionsgedanke 
 xpansionsgelüste ( ) lemma=Expansionsgelüsten 
 xpansionshunge ( ) lemma=Expansionshunger 
 xpansionsinteresse ( ) lemma=Expansionsinteresse 
 xpansionskraf ( ) lemma=Expansionskraft 
 xpansionskur ( ) lemma=Expansionskurs 
 xpansionslus ( ) lemma=Expansionslust 
 xpansionsmöglichkei ( ) lemma=Expansionsmöglichkeit 
 xpansionsmöglichkeite ( ) lemma=Expansionsmöglichkeit 
 xpansionspfa ( ) lemma=Expansionspfad 
 xpansionsphas ( ) lemma=Expansionsphase 
 xpansionsplän ( ) lemma=Expansionsplan 
 xpansionspläne ( ) lemma=Expansionsplan 
 xpansionspoliti ( ) lemma=Expansionspolitik 
 xpansionsprogram ( ) lemma=Expansionsprogramm 
 xpansionsprozes ( ) lemma=Expansionsprozess 
 xpansionsproze ( ) lemma=Expansionsprozess 
 xpansionsrau ( ) lemma=Expansionsraum 
 xpansionsschlag ( ) lemma=Expansionsschlag 
 xpansionsschwerpunk ( ) lemma=Expansionsschwerpunkt 
 xpansionsstrategi ( ) lemma=Expansionsstrategie 
 xpansionsstrategie ( ) lemma=Expansionsstrategie 
 xpansionsstrebe ( ) lemma=Expansionsstreben 
 xpansionstemp ( ) lemma=Expansionstempo 
 xpansionsträum ( ) lemma=Expansionstraum 
 xpansionswünsch ( ) lemma=Expansionswunsch 
 xpeditio ( ) lemma=Expedition 
 xpeditione ( ) lemma=Expedition 
 xpeditionsabschnitt ( ) lemma=Expeditionsabschnitt 
 xpeditionsbergsteige ( ) lemma=Expeditionsbergsteiger 
 xpeditionsberichte ( ) lemma=Expeditionsbericht 
 xpeditionsheere ( ) lemma=Expeditionsheer 
 xpeditionskorp ( ) lemma=Expeditionskorps 
 xpeditionsleite ( ) lemma=Expeditionsleiter 
 xpeditionsleiteri ( ) lemma=Expeditionsleiterin 
 xpeditionsleitun ( ) lemma=Expeditionsleitung 
 xpeditionsmitglie ( ) lemma=Expeditionsmitglied 
 xpeditionspla ( ) lemma=Expeditionsplan 
 xpeditionsreis ( ) lemma=Expeditionsreise 
 xpeditionsschif ( ) lemma=Expeditionsschiff 
 xpeditionsstreitmach ( ) lemma=Expeditionsstreitmacht 
 xpeditionstea ( ) lemma=Expeditionsteam 
 xpeditionsteilnehme ( ) lemma=Expeditionsteilnehmer 
 xpedito ( ) lemma=Expeditor 
 xperimen ( ) lemma=Experiment 
 xperimental ( ) lemma=experimental 
 xperimental-Untersuchun ( ) lemma=Experimental-Untersuchung 
 xperimental-Video ( ) lemma=Experimental-Video 
 xperimentalbühn ( ) lemma=Experimentalbühne 
 xperimentalfahrzeu ( ) lemma=Experimentalfahrzeug 
 xperimentalfil ( ) lemma=Experimentalfilm 
 xperimentalfilm ( ) lemma=Experimentalfilm 
 xperimentalfilme ( ) lemma=Experimentalfilm 
 xperimentalfilmschuppe ( ) lemma=Experimentalfilmschuppen 
 xperimentalgrafike ( ) lemma=Experimentalgrafiker 
 xperimentalmusi ( ) lemma=Experimentalmusik 
 xperimentalmusike ( ) lemma=Experimentalmusiker 
 xperimentalphas ( ) lemma=Experimentalphase 
 xperimentalphysi ( ) lemma=Experimentalphysik 
 xperimentalphysike ( ) lemma=Experimentalphysiker 
 xperimentalprogram ( ) lemma=Experimentalprogramm 
 xperimentalpsychologi ( ) lemma=Experimentalpsychologie 
 xperimentalreakto ( ) lemma=Experimentalreaktor 
 xperimentalstadiu ( ) lemma=Experimentalstadium 
 xperimentalstreife ( ) lemma=Experimentalstreifen 
 xperimentalstudi ( ) lemma=Experimentalstudio 
 xperimentalstunde ( ) lemma=Experimentalstunde 
 xperimentaltheate ( ) lemma=Experimentaltheater 
 xperimentalvide ( ) lemma=Experimentalvideo 
 xperimentalvortra ( ) lemma=Experimentalvortrag 
 xperimentcharakte ( ) lemma=Experimentcharakter 
 xperiment ( ) lemma=Experiment 
 xperimentell ( ) lemma=experimentell 
 xperimentelle ( ) lemma=experimentell 
 xperimente ( ) lemma=Experiment 
 xperimentier ( ) lemma=experimentieren 
 xperimentier-Reakto ( ) lemma=Experimentier-Reaktor 
 xperimentiere ( ) lemma=experimentieren 
 xperimentieren ( ) lemma=experimentierend 
 xperimentierfreud ( ) lemma=Experimentierfreude 
 xperimentierlus ( ) lemma=Experimentierlust 
 xpert ( ) lemma=Experte 
 xperte ( ) lemma=Experte 
 xperten ( ) lemma=Experten- 
 xperten-Anhörun ( ) lemma=Experten-Anhörung 
 xperten-Bemühunge ( ) lemma=Experten-Bemühung 
 xperten-Berich ( ) lemma=Experten-Bericht 
 xperten-Diskussio ( ) lemma=Experten-Diskussion 
 xperten-Diskussione ( ) lemma=Experten-Diskussion 
 xperten-Empfehlun ( ) lemma=Experten-Empfehlung 
 xperten-Gespräc ( ) lemma=Experten-Gespräch 
 xperten-Grupp ( ) lemma=Experten-Gruppe 
 xperten-Gutachte ( ) lemma=Experten-Gutachten 
 xperten-Jur ( ) lemma=Experten-Jury 
 xperten-Kolloquiu ( ) lemma=Experten-Kolloquium 
 xperten-Kommissio ( ) lemma=Experten-Kommission 
 xperten-Kommissione ( ) lemma=Experten-Kommission 
 xperten-Konferen ( ) lemma=Experten-Konferenz 
 xperten-Meinun ( ) lemma=Experten-Meinung 
 xperten-Rund ( ) lemma=Experten-Runde 
 xperten-Runde ( ) lemma=Experten-Runde 
 xperten-Schätzunge ( ) lemma=Experten-Schätzung 
 xperten-Tea ( ) lemma=Experten-Team 
 xperten-Team ( ) lemma=Experten-Team 
 xperten-Workshop ( ) lemma=Experten-Workshop 
 xpertenanalys ( ) lemma=Expertenanalyse 
 xpertenanalyse ( ) lemma=Expertenanalyse 
 xpertenangabe ( ) lemma=Expertenangabe 
 xpertenangebote ( ) lemma=Expertenangebot 
 xpertenanhörun ( ) lemma=Expertenanhörung 
 xpertenanhörunge ( ) lemma=Expertenanhörung 
 xpertenansich ( ) lemma=Expertenansicht 
 xpertenaussage ( ) lemma=Expertenaussage 
 xpertenausschus ( ) lemma=Expertenausschuss 
 xpertenausschusse ( ) lemma=Expertenausschuss 
 xpertenausschu ( ) lemma=Expertenausschuss 
 xpertenaustausc ( ) lemma=Expertenaustausch 
 xpertenbefragun ( ) lemma=Expertenbefragung 
 xpertenbefragunge ( ) lemma=Expertenbefragung 
 xpertenberatun ( ) lemma=Expertenberatung 
 xpertenberatunge ( ) lemma=Expertenberatung 
 xpertenberechnunge ( ) lemma=Expertenberechnung 
 xpertenberich ( ) lemma=Expertenbericht 
 xpertenbericht ( ) lemma=Expertenbericht 
 xpertendebatt ( ) lemma=Expertendebatte 
 xpertendelegatio ( ) lemma=Expertendelegation 
 xpertendiskussio ( ) lemma=Expertendiskussion 
 xpertendiskussione ( ) lemma=Expertendiskussion 
 xperteneben ( ) lemma=Expertenebene 
 xperteneinschätzun ( ) lemma=Experteneinschätzung 
 xperteneinschätzunge ( ) lemma=Experteneinschätzung 
 xpertenfond ( ) lemma=Expertenfonds 
 xpertenforu ( ) lemma=Expertenforum 
 xpertengespräc ( ) lemma=Expertengespräch 
 xpertengespräch ( ) lemma=Expertengespräch 
 xpertengespräche ( ) lemma=Expertengespräch 
 xpertengremie ( ) lemma=Expertengremium 
 xpertengremiu ( ) lemma=Expertengremium 
 xpertengremium ( ) lemma=Expertengremium 
 xpertengriff ( ) lemma=Expertengriff 
 xpertengrupp ( ) lemma=Expertengruppe 
 xpertengruppe ( ) lemma=Expertengruppe 
 xpertengutachte ( ) lemma=Expertengutachten 
 xpertenhierarchi ( ) lemma=Expertenhierarchie 
 xpertenhilf ( ) lemma=Expertenhilfe 
 xpertenintelligen ( ) lemma=Expertenintelligenz 
 xpertenkabinet ( ) lemma=Expertenkabinett 
 xpertenkolloquiu ( ) lemma=Expertenkolloquium 
 xpertenkomite ( ) lemma=Expertenkomitee 
 xpertenkomitee ( ) lemma=Expertenkomitee 
 xpertenkommissio ( ) lemma=Expertenkommission 
 xpertenkommissione ( ) lemma=Expertenkommission 
 xpertenkompeten ( ) lemma=Expertenkompetenz 
 xpertenkompromis ( ) lemma=Expertenkompromiss 
 xpertenkompromi ( ) lemma=Expertenkompromiss 
 xpertenkonferen ( ) lemma=Expertenkonferenz 
 xpertenkonferenze ( ) lemma=Expertenkonferenz 
 xpertenkrei ( ) lemma=Expertenkreis 
 xpertenkreise ( ) lemma=Expertenkreis 
 xpertenkriti ( ) lemma=Expertenkritik 
 xpertenkultu ( ) lemma=Expertenkultur 
 xpertenkürze ( ) lemma=Expertenkürzel 
 xpertenmach ( ) lemma=Expertenmacht 
 xpertenmeinun ( ) lemma=Expertenmeinung 
 xpertenmeinunge ( ) lemma=Expertenmeinung 
 xpertenmissio ( ) lemma=Expertenmission 
 xpertenpapie ( ) lemma=Expertenpapier 
 xpertenpodiu ( ) lemma=Expertenpodium 
 xpertenprogram ( ) lemma=Expertenprogramm 
 xpertenra ( ) lemma=Expertenrat 
 xpertenrat ( ) lemma=Expertenrat 
 xpertenrechnun ( ) lemma=Expertenrechnung 
 xpertenrechnunge ( ) lemma=Expertenrechnung 
 xpertenregierun ( ) lemma=Expertenregierung 
 xpertenrund ( ) lemma=Expertenrunde 
 xpertenrunde ( ) lemma=Expertenrunde 
 xpertensach ( ) lemma=Expertensache 
 xpertenschreibe ( ) lemma=Expertenschreiben 
 xpertenschätzun ( ) lemma=Expertenschätzung 
 xpertenschätzunge ( ) lemma=Expertenschätzung 
 xpertensemina ( ) lemma=Expertenseminar 
 xpertenservic ( ) lemma=Expertenservice 
 xpertensich ( ) lemma=Expertensicht 
 xpertensitzun ( ) lemma=Expertensitzung 
 xpertensta ( ) lemma=Expertenstab 
 xpertenstimme ( ) lemma=Expertenstimme 
 xpertenstrei ( ) lemma=Expertenstreit 
 xpertenstudi ( ) lemma=Expertenstudie 
 xpertenstäb ( ) lemma=Expertenstab 
 xpertenstäbe ( ) lemma=Expertenstab 
 xpertensymposiu ( ) lemma=Expertensymposium 
 xpertensyste ( ) lemma=Expertensystem 
 xpertensystem ( ) lemma=Expertensystem 
 xpertensysteme ( ) lemma=Expertensystem 
 xpertentagun ( ) lemma=Expertentagung 
 xpertentagunge ( ) lemma=Expertentagung 
 xpertentea ( ) lemma=Expertenteam 
 xpertenteam ( ) lemma=Expertenteam 
 xpertentreffe ( ) lemma=Expertentreffen 
 xpertentreffen ( ) lemma=Expertentreffen 
 xpertentrupp ( ) lemma=Expertentruppe 
 xpertenuntersuchun ( ) lemma=Expertenuntersuchung 
 xpertenuntersuchunge ( ) lemma=Expertenuntersuchung 
 xpertenurtei ( ) lemma=Expertenurteil 
 xpertenverhandlunge ( ) lemma=Expertenverhandlung 
 xpertenversammlun ( ) lemma=Expertenversammlung 
 xpertenvotu ( ) lemma=Expertenvotum 
 xpertenwel ( ) lemma=Expertenwelt 
 xpertenwisse ( ) lemma=Expertenwissen 
 xpertenwort ( ) lemma=Expertenwort 
 xpertenzirke ( ) lemma=Expertenzirkel 
 xpertenzirkel ( ) lemma=Expertenzirkel 
 xperti ( ) lemma=Expertin 
 xpertinne ( ) lemma=Expertin 
 xpertinnen-Beratungsnet ( ) lemma=Expertinnen-Beratungsnetz 
 xpertinnenwisse ( ) lemma=Expertinnenwissen 
 xpertis ( ) lemma=Expertise 
 xpertise ( ) lemma=Expertise 
 xplantatio ( ) lemma=Explantation 
 xplikatio ( ) lemma=Explikation 
 xplizit ( ) lemma=explizit 
 xplizite ( ) lemma=explizit 
 xplodiere ( ) lemma=explodieren 
 xplodierend ( ) lemma=explodierend 
 xploitatio ( ) lemma=Exploitation 
 xploratio ( ) lemma=Exploration 
 xploratione ( ) lemma=Exploration 
 xplorationsbohrunge ( ) lemma=Explorationsbohrung 
 xplorationsgenehmigun ( ) lemma=Explorationsgenehmigung 
 xplosio ( ) lemma=Explosion 
 xplosione ( ) lemma=Explosion 
 xplosions ( ) lemma=Explosions- 
 xplosionsartig ( ) lemma=explosionsartig 
 xplosionsartige ( ) lemma=explosionsartig 
 xplosionsdruc ( ) lemma=Explosionsdruck 
 xplosionsgefah ( ) lemma=Explosionsgefahr 
 xplosionsgefahre ( ) lemma=Explosionsgefahr 
 xplosionsgefährdet ( ) lemma=explosionsgefährdet 
 xplosionsgeräusch ( ) lemma=Explosionsgeräusch 
 xplosionsgeschützte ( ) lemma=explosionsgeschützt 
 xplosionsgrenz ( ) lemma=Explosionsgrenze 
 xplosionsgrupp ( ) lemma=Explosionsgruppe 
 xplosionsher ( ) lemma=Explosionsherd 
 xplosionskatastroph ( ) lemma=Explosionskatastrophe 
 xplosionsknal ( ) lemma=Explosionsknall 
 xplosionskraf ( ) lemma=Explosionskraft 
 xplosionskörpe ( ) lemma=Explosionskörper 
 xplosionslär ( ) lemma=Explosionslärm 
 xplosionsmoto ( ) lemma=Explosionsmotor 
 xplosionsor ( ) lemma=Explosionsort 
 xplosionsorte ( ) lemma=Explosionsort 
 xplosionsrisik ( ) lemma=Explosionsrisiko 
 xplosionsrisiko ( ) lemma=Explosionsrisiko 
 xplosionsschut ( ) lemma=Explosionsschutz 
 xplosionsschutz-Norme ( ) lemma=Explosionsschutz-Norm 
 xplosionsschutzkennzeichnun ( ) lemma=Explosionsschutzkennzeichnung 
 xplosionsseri ( ) lemma=Explosionsserie 
 xplosionsstoff ( ) lemma=Explosionsstoff 
 xplosionsunglüc ( ) lemma=Explosionsunglück 
 xplosionsunglück ( ) lemma=Explosionsunglück 
 xplosionsursach ( ) lemma=Explosionsursache 
 xplosionswell ( ) lemma=Explosionswelle 
 xplosiv ( ) lemma=explosiv 
 xplosiv-Magazi ( ) lemma=Explosiv-Magazin 
 xplosiv-Schock ( ) lemma=Explosiv-Schock 
 xplosive ( ) lemma=explosiv 
 xplosivgemisc ( ) lemma=Explosivgemisch 
 xplosivkraf ( ) lemma=Explosivkraft 
 xplosivkörpe ( ) lemma=Explosivkörper 
 xplosivmischun ( ) lemma=Explosivmischung 
 xplosivsti ( ) lemma=Explosivstil 
 xplosivstof ( ) lemma=Explosivstoff 
 xplosivstoff ( ) lemma=Explosivstoff 
 xplosivstoffe ( ) lemma=Explosivstoff 
 xp ( ) lemma=Expo 
 xpo ( ) lemma=Expo- 
 xpo-Abstimmun ( ) lemma=Expo-Abstimmung 
 xpo-Beauftragte ( ) lemma=Expo-Beauftragte 
 xpo-Befürworte ( ) lemma=Expo-Befürworter 
 xpo-Besuche ( ) lemma=Expo-Besucher 
 xpo-Eintrittskarte ( ) lemma=Expo-Eintrittskarte 
 xpo-Fa ( ) lemma=Expo-Fan 
 xpo-Fiebe ( ) lemma=Expo-Fieber 
 xpo-Finanzierun ( ) lemma=Expo-Finanzierung 
 xpo-Gegne ( ) lemma=Expo-Gegner 
 xpo-Gelde ( ) lemma=Expo-Geld 
 xpo-Geländ ( ) lemma=Expo-Gelände 
 xpo-Gelände ( ) lemma=Expo-Gelände 
 xpo-Gesellschaf ( ) lemma=Expo-Gesellschaft 
 xpo-Gesellschafte ( ) lemma=Expo-Gesellschaft 
 xpo-Konzep ( ) lemma=Expo-Konzept 
 xpo-Milliarde ( ) lemma=Expo-Milliarde 
 xpo-Planun ( ) lemma=Expo-Planung 
 xpo-Them ( ) lemma=Expo-Thema 
 xpo-Verkeh ( ) lemma=Expo-Verkehr 
 xpo-Vertra ( ) lemma=Expo-Vertrag 
 xpo-Zu ( ) lemma=Expo-Zug 
 xpona ( ) lemma=Exponat 
 xponat ( ) lemma=Exponat 
 xponate ( ) lemma=Exponat 
 xponatensammlun ( ) lemma=Exponatensammlung 
 xponen ( ) lemma=Exponent 
 xponente ( ) lemma=Exponent 
 xponentialrechnun ( ) lemma=Exponentialrechnung 
 xponenti ( ) lemma=Exponentin 
 xponiere ( ) lemma=exponieren 
 xponiert ( ) lemma=exponiert 
 xpor ( ) lemma=Export 
 xport ( ) lemma=Export 
 xport-Antra ( ) lemma=Export-Antrag 
 xport-Boo ( ) lemma=Export-Boom 
 xport-Dumpin ( ) lemma=Export-Dumping 
 xport-Finanzierunge ( ) lemma=Export-Finanzierung 
 xport-Geschäf ( ) lemma=Export-Geschäft 
 xport-Geschäft ( ) lemma=Export-Geschäft 
 xport-Gesellschaf ( ) lemma=Export-Gesellschaft 
 xport-Impor ( ) lemma=Export-Import 
 xport-Import ( ) lemma=Export-Import- 
 xport-Import-Ban ( ) lemma=Export-Import-Bank 
 xport-Import-Geschäf ( ) lemma=Export-Import-Geschäft 
 xport-Kontrolle ( ) lemma=Export-Kontrolle 
 xport-Lizenzanträge ( ) lemma=Export-Lizenzantrag 
 xport-Mess ( ) lemma=Export-Messe 
 xport-Politi ( ) lemma=Export-Politik 
 xport-Produkte ( ) lemma=Export-Produkt 
 xport-Rube ( ) lemma=Export-Rubel 
 xport-Skanda ( ) lemma=Export-Skandal 
 xport-Skandal ( ) lemma=Export-Skandal 
 xport-Unio ( ) lemma=Export-Union 
 xport-Weltmeiste ( ) lemma=Export-Weltmeister 
 xport-Weltmeister ( ) lemma=Export-Weltmeister 
 xportabhängigkei ( ) lemma=Exportabhängigkeit 
 xportabsat ( ) lemma=Exportabsatz 
 xportabsichte ( ) lemma=Exportabsicht 
 xportabteilun ( ) lemma=Exportabteilung 
 xportakademi ( ) lemma=Exportakademie 
 xportanforderunge ( ) lemma=Exportanforderung 
 xportangebo ( ) lemma=Exportangebot 
 xportanstie ( ) lemma=Exportanstieg 
 xportanstrengunge ( ) lemma=Exportanstrengung 
 xportantei ( ) lemma=Exportanteil 
 xportanteil ( ) lemma=Exportanteil 
 xportantra ( ) lemma=Exportantrag 
 xportanträg ( ) lemma=Exportantrag 
 xportanträge ( ) lemma=Exportantrag 
 xportartike ( ) lemma=Exportartikel 
 xportartikel ( ) lemma=Exportartikel 
 xportaufschwun ( ) lemma=Exportaufschwung 
 xportaufträg ( ) lemma=Exportauftrag 
 xportaufträge ( ) lemma=Exportauftrag 
 xportausfal ( ) lemma=Exportausfall 
 xportaussichte ( ) lemma=Exportaussicht 
 xportbedingunge ( ) lemma=Exportbedingung 
 xportbegehre ( ) lemma=Exportbegehren 
 xportbeihilfe ( ) lemma=Exportbeihilfe 
 xportbemühunge ( ) lemma=Exportbemühung 
 xportberatun ( ) lemma=Exportberatung 
 xportbereic ( ) lemma=Exportbereich 
 xportbeschränkun ( ) lemma=Exportbeschränkung 
 xportbeschränkunge ( ) lemma=Exportbeschränkung 
 xportbestimmunge ( ) lemma=Exportbestimmung 
 xportbetrieb ( ) lemma=Exportbetrieb 
 xportbeziehunge ( ) lemma=Exportbeziehung 
 xportbie ( ) lemma=Exportbier 
 xportbierbrauere ( ) lemma=Exportbierbrauerei 
 xportbilan ( ) lemma=Exportbilanz 
 xportblockade ( ) lemma=Exportblockade 
 xportboo ( ) lemma=Exportboom 
 xportbranch ( ) lemma=Exportbranche 
 xportbranche ( ) lemma=Exportbranche 
 xportbürgschafte ( ) lemma=Exportbürgschaft 
 xportbür ( ) lemma=Exportbüro 
 xportbüro ( ) lemma=Exportbüro 
 xportchanc ( ) lemma=Exportchance 
 xportchance ( ) lemma=Exportchance 
 xportche ( ) lemma=Exportchef 
 xportchef ( ) lemma=Exportchef 
 xportdruc ( ) lemma=Exportdruck 
 xporteinbruc ( ) lemma=Exporteinbruch 
 xporteinbrüch ( ) lemma=Exporteinbruch 
 xporteinbusse ( ) lemma=Exporteinbuße 
 xporteinbuße ( ) lemma=Exporteinbuße 
 xporteinkünft ( ) lemma=Exporteinkunft 
 xporteinnahme ( ) lemma=Exporteinnahme 
 xporte ( ) lemma=Export 
 xportentwicklun ( ) lemma=Exportentwicklung 
 xporterfol ( ) lemma=Exporterfolg 
 xporterfolg ( ) lemma=Exporterfolg 
 xporterfolge ( ) lemma=Exporterfolg 
 xporterlaubni ( ) lemma=Exporterlaubnis 
 xporterleichterunge ( ) lemma=Exporterleichterung 
 xporterlö ( ) lemma=Exporterlös 
 xporterlös ( ) lemma=Exporterlös 
 xporterlöse ( ) lemma=Exporterlös 
 xporterstattun ( ) lemma=Exporterstattung 
 xporterstattunge ( ) lemma=Exporterstattung 
 xporterwartunge ( ) lemma=Exporterwartung 
 xporteu ( ) lemma=Exporteur 
 xporteur ( ) lemma=Exporteur 
 xporteure ( ) lemma=Exporteur 
 xportfakto ( ) lemma=Exportfaktor 
 xportfinanzierun ( ) lemma=Exportfinanzierung 
 xportfirm ( ) lemma=Exportfirma 
 xportfirme ( ) lemma=Exportfirma 
 xportflaut ( ) lemma=Exportflaute 
 xportfond ( ) lemma=Exportfonds 
 xportfrüchte ( ) lemma=Exportfrucht 
 xportfähigkei ( ) lemma=Exportfähigkeit 
 xportförderun ( ) lemma=Exportförderung 
 xportförderunge ( ) lemma=Exportförderung 
 xportförderungsinstrumen ( ) lemma=Exportförderungsinstrument 
 xportgarantie ( ) lemma=Exportgarantie 
 xportgarantieprogramm ( ) lemma=Exportgarantieprogramm 
 xportgenehmigun ( ) lemma=Exportgenehmigung 
 xportgenehmigunge ( ) lemma=Exportgenehmigung 
 xportgenehmigungsverfahre ( ) lemma=Exportgenehmigungsverfahren 
 xportgeschäf ( ) lemma=Exportgeschäft 
 xportgeschäft ( ) lemma=Exportgeschäft 
 xportgeschäfte ( ) lemma=Exportgeschäft 
 xportgesellschaf ( ) lemma=Exportgesellschaft 
 xportgesetz ( ) lemma=Exportgesetz 
 xportgesetzgebun ( ) lemma=Exportgesetzgebung 
 xportgewinn ( ) lemma=Exportgewinn 
 xportgu ( ) lemma=Exportgut 
 xportgut ( ) lemma=Exportgut 
 xportgüte ( ) lemma=Exportgut 
 xportgüter ( ) lemma=Exportgut 
 xporthafe ( ) lemma=Exporthafen 
 xporthande ( ) lemma=Exporthandel 
 xporthemmniss ( ) lemma=Exporthemmnis 
 xporthilfe ( ) lemma=Exporthilfe 
 xporthi ( ) lemma=Exporthit 
 xportiere ( ) lemma=exportieren 
 xportiert ( ) lemma=exportiert 
 xportindustrialisierun ( ) lemma=Exportindustrialisierung 
 xportindustri ( ) lemma=Exportindustrie 
 xportindustrie ( ) lemma=Exportindustrie 
 xportinteresse ( ) lemma=Exportinteresse 
 xportkapazitäte ( ) lemma=Exportkapazität 
 xportkaufman ( ) lemma=Exportkaufmann 
 xportkiste ( ) lemma=Exportkiste 
 xportkonjunktu ( ) lemma=Exportkonjunktur 
 xportkontrollbehörd ( ) lemma=Exportkontrollbehörde 
 xportkontrollbestimmunge ( ) lemma=Exportkontrollbestimmung 
 xportkontroll ( ) lemma=Exportkontrolle 
 xportkontrolle ( ) lemma=Exportkontrolle 
 xportkontrolleu ( ) lemma=Exportkontrolleur 
 xportkontrolleur ( ) lemma=Exportkontrolleur 
 xportkontrollgesetz ( ) lemma=Exportkontrollgesetz 
 xportkontrollmassnahme ( ) lemma=Exportkontrollmaßnahme 
 xportkontrollmaßnahme ( ) lemma=Exportkontrollmaßnahme 
 xportkontrollregim ( ) lemma=Exportkontrollregime 
 xportkontrollsyste ( ) lemma=Exportkontrollsystem 
 xportkontrollvorschrifte ( ) lemma=Exportkontrollvorschrift 
 xportkraf ( ) lemma=Exportkraft 
 xportkredi ( ) lemma=Exportkredit 
 xportkredit ( ) lemma=Exportkredit 
 xportkredite ( ) lemma=Exportkredit 
 xportkreditversicherun ( ) lemma=Exportkreditversicherung 
 xportkreditversicherunge ( ) lemma=Exportkreditversicherung 
 xportkuche ( ) lemma=Exportkuchen 
 xportkulture ( ) lemma=Exportkultur 
 xportkur ( ) lemma=Exportkurs 
 xportlade ( ) lemma=Exportladen 
 xportlan ( ) lemma=Exportland 
 xportlande ( ) lemma=Exportland 
 xportleistun ( ) lemma=Exportleistung 
 xportleistunge ( ) lemma=Exportleistung 
 xportleite ( ) lemma=Exportleiter 
 xportlieferunge ( ) lemma=Exportlieferung 
 xportlist ( ) lemma=Exportliste 
 xportlizen ( ) lemma=Exportlizenz 
 xportlizenze ( ) lemma=Exportlizenz 
 xportläde ( ) lemma=Exportläden 
 xportlände ( ) lemma=Exportland 
 xportländer ( ) lemma=Exportland 
 xportmach ( ) lemma=Exportmacht 
 xportmanage ( ) lemma=Exportmanager 
 xportmark ( ) lemma=Exportmarkt 
 xportmarkte ( ) lemma=Exportmarkt 
 xportmarkt ( ) lemma=Exportmarkt 
 xportmaschin ( ) lemma=Exportmaschine 
 xportmeng ( ) lemma=Exportmenge 
 xportmenge ( ) lemma=Exportmenge 
 xportmodel ( ) lemma=Exportmodell 
 xportmodell ( ) lemma=Exportmodell 
 xportmoto ( ) lemma=Exportmotor 
 xportmärkt ( ) lemma=Exportmarkt 
 xportmärkte ( ) lemma=Exportmarkt 
 xportmöglichkeite ( ) lemma=Exportmöglichkeit 
 xportnachfrag ( ) lemma=Exportnachfrage 
 xportnachteil ( ) lemma=Exportnachteil 
 xportnachweise ( ) lemma=Exportnachweis 
 xportnatio ( ) lemma=Exportnation 
 xportnatione ( ) lemma=Exportnation 
 xportoffensiv ( ) lemma=Exportoffensive 
 xportorganisatione ( ) lemma=Exportorganisation 
 xportorientierun ( ) lemma=Exportorientierung 
 xportpalett ( ) lemma=Exportpalette 
 xportpapier ( ) lemma=Exportpapier 
 xportpla ( ) lemma=Exportplan 
 xportplu ( ) lemma=Exportplus 
 xportpoliti ( ) lemma=Exportpolitik 
 xportpotentia ( ) lemma=Exportpotential 
 xportpraktike ( ) lemma=Exportpraktik 
 xportpraxi ( ) lemma=Exportpraxen 
 xportpreisdumpin ( ) lemma=Exportpreisdumping 
 xportpreis ( ) lemma=Exportpreis 
 xportproblem ( ) lemma=Exportproblem 
 xportproduk ( ) lemma=Exportprodukt 
 xportprodukt ( ) lemma=Exportprodukt 
 xportprodukte ( ) lemma=Exportprodukt 
 xportproduktio ( ) lemma=Exportproduktion 
 xportproduktionszon ( ) lemma=Exportproduktionszone 
 xportprogram ( ) lemma=Exportprogramm 
 xportqualitäte ( ) lemma=Exportqualität 
 xportquot ( ) lemma=Exportquote 
 xportquote ( ) lemma=Exportquote 
 xportquotenabkomme ( ) lemma=Exportquotenabkommen 
 xportquotensystem ( ) lemma=Exportquotensystem 
 xportrate ( ) lemma=Exportrate 
 xportrecht ( ) lemma=Exportrecht 
 xportregel ( ) lemma=Exportregel 
 xportregio ( ) lemma=Exportregion 
 xportregione ( ) lemma=Exportregion 
 xportrekor ( ) lemma=Exportrekord 
 xportrestriktione ( ) lemma=Exportrestriktion 
 xportrichtlinie ( ) lemma=Exportrichtlinie 
 xportriese ( ) lemma=Exportriese 
 xportrisike ( ) lemma=Exportrisiko 
 xportrückgan ( ) lemma=Exportrückgang 
 xportrückgang ( ) lemma=Exportrückgang 
 xportrückgäng ( ) lemma=Exportrückgang 
 xportsachbearbeite ( ) lemma=Exportsachbearbeiter 
 xportschlage ( ) lemma=Exportschlager 
 xportschlager ( ) lemma=Exportschlager 
 xportschu ( ) lemma=Exportschub 
 xportschwierigkeite ( ) lemma=Exportschwierigkeit 
 xportschwäch ( ) lemma=Exportschwäche 
 xportsekto ( ) lemma=Exportsektor 
 xportskanda ( ) lemma=Exportskandal 
 xportskandal ( ) lemma=Exportskandal 
 xportskandale ( ) lemma=Exportskandal 
 xportsperr ( ) lemma=Exportsperre 
 xportstatisti ( ) lemma=Exportstatistik 
 xportsteigerun ( ) lemma=Exportsteigerung 
 xportsteigerunge ( ) lemma=Exportsteigerung 
 xportsteue ( ) lemma=Exportsteuer 
 xportsteuer ( ) lemma=Exportsteuer 
 xportsto ( ) lemma=Exportstop 
 xportstop ( ) lemma=Exportstopp 
 xportstrategi ( ) lemma=Exportstrategie 
 xportstruktu ( ) lemma=Exportstruktur 
 xportström ( ) lemma=Exportstrom 
 xportstützpunkt ( ) lemma=Exportstützpunkt 
 xportsubventio ( ) lemma=Exportsubvention 
 xportsubventione ( ) lemma=Exportsubvention 
 xportsumm ( ) lemma=Exportsumme 
 xporttätigkei ( ) lemma=Exporttätigkeit 
 xportumsat ( ) lemma=Exportumsatz 
 xportumsatze ( ) lemma=Exportumsatz 
 xportumsätz ( ) lemma=Exportumsatz 
 xportunternehme ( ) lemma=Exportunternehmen 
 xportunterstützun ( ) lemma=Exportunterstützung 
 xportventi ( ) lemma=Exportventil 
 xportverbo ( ) lemma=Exportverbot 
 xportverbot ( ) lemma=Exportverbot 
 xportverbote ( ) lemma=Exportverbot 
 xportverbotslist ( ) lemma=Exportverbotsliste 
 xportverhalte ( ) lemma=Exportverhalten 
 xportverlust ( ) lemma=Exportverlust 
 xportverluste ( ) lemma=Exportverlust 
 xportverpflichtunge ( ) lemma=Exportverpflichtung 
 xportversicherun ( ) lemma=Exportversicherung 
 xportversicherunge ( ) lemma=Exportversicherung 
 xportversio ( ) lemma=Exportversion 
 xportversuc ( ) lemma=Exportversuch 
 xportverträg ( ) lemma=Exportvertrag 
 xportvolume ( ) lemma=Exportvolumen 
 xportvolumen ( ) lemma=Exportvolumen 
 xportvorschrifte ( ) lemma=Exportvorschrift 
 xportwachstu ( ) lemma=Exportwachstum 
 xportwar ( ) lemma=Exportware 
 xportware ( ) lemma=Exportware 
 xportweltmeiste ( ) lemma=Exportweltmeister 
 xportweltmeister ( ) lemma=Exportweltmeister 
 xportwer ( ) lemma=Exportwert 
 xportwert ( ) lemma=Exportwert 
 xportwirtschaf ( ) lemma=Exportwirtschaft 
 xportwunde ( ) lemma=Exportwunder 
 xportwunder ( ) lemma=Exportwunder 
 xportwu ( ) lemma=Exportwut 
 xportzahle ( ) lemma=Exportzahl 
 xportziel ( ) lemma=Exportziel 
 xportziffer ( ) lemma=Exportziffer 
 xportzunahm ( ) lemma=Exportzunahme 
 xportzuschüss ( ) lemma=Exportzuschuss 
 xportzuwach ( ) lemma=Exportzuwachs 
 xportzuwächs ( ) lemma=Exportzuwachs 
 xportzwan ( ) lemma=Exportzwang 
 xportzwei ( ) lemma=Exportzweig 
 xportzöll ( ) lemma=Exportzoll 
 xportökonomi ( ) lemma=Exportökonomie 
 xportüberschus ( ) lemma=Exportüberschuss 
 xportüberschusse ( ) lemma=Exportüberschuss 
 xportüberschu ( ) lemma=Exportüberschuss 
 xportüberschüss ( ) lemma=Exportüberschuss 
 xportüberschüsse ( ) lemma=Exportüberschuss 
 xpos ( ) lemma=Exposé 
 xpose ( ) lemma=Exposé 
 xpositio ( ) lemma=Exposition 
 xpositione ( ) lemma=Exposition 
 xpositionsbedingunge ( ) lemma=Expositionsbedingung 
 xpositionsdruc ( ) lemma=Expositionsdruck 
 xpositionsgra ( ) lemma=Expositionsgrad 
 xpos ( ) lemma=Exposé 
 xpremie ( ) lemma=Expremier 
 xpremierministe ( ) lemma=Expremierminister 
 xpremierministeri ( ) lemma=Expremierministerin 
 xpremier ( ) lemma=Expremier 
 xpres ( ) lemma=express 
 xpress ( ) lemma=Express- 
 xpress-Abitu ( ) lemma=Express-Abitur 
 xpress-Bu ( ) lemma=Express-Bus 
 xpress-Lo ( ) lemma=Express-Lok 
 xpress-Reisehandbuc ( ) lemma=Express-Reisehandbuch 
 xpress-Reisehandbüche ( ) lemma=Express-Reisehandbuch 
 xpress-Schalte ( ) lemma=Express-Schalter 
 xpress-Züg ( ) lemma=Express-Zug 
 xpressabitu ( ) lemma=Expressabitur 
 xpressbu ( ) lemma=Expressbus 
 xpressbuslini ( ) lemma=Expressbuslinie 
 xpressdiens ( ) lemma=Expressdienst 
 xpressgu ( ) lemma=Expressgut 
 xpressgutabfertigun ( ) lemma=Expressgutabfertigung 
 xpressguthall ( ) lemma=Expressguthalle 
 xpressio ( ) lemma=Expression 
 xpressionismu ( ) lemma=Expressionismus 
 xpressionismus ( ) lemma=Expressionismus- 
 xpressionismus-Ausstellun ( ) lemma=Expressionismus-Ausstellung 
 xpressionismusdebatt ( ) lemma=Expressionismusdebatte 
 xpressionis ( ) lemma=Expressionist 
 xpressioniste ( ) lemma=Expressionist 
 xpressionisten ( ) lemma=Expressionisten- 
 xpressionisten-Sammlun ( ) lemma=Expressionisten-Sammlung 
 xpressionistenausstellun ( ) lemma=Expressionistenausstellung 
 xpressionisti ( ) lemma=Expressionistin 
 xpressionistinne ( ) lemma=Expressionistin 
 xpressionistisch ( ) lemma=expressionistisch 
 xpressiv ( ) lemma=expressiv 
 xpressive ( ) lemma=expressiv 
 xpressivitä ( ) lemma=Expressivität 
 xpresspaket ( ) lemma=Expresspaket 
 xpressschalte ( ) lemma=Expressschalter 
 xpresssendunge ( ) lemma=Expresssendung 
 xpresstemp ( ) lemma=Expresstempo 
 xpresszu ( ) lemma=Expresszug 
 xpresszuge ( ) lemma=Expresszug 
 xpresszüg ( ) lemma=Expresszug 
 xpresszüge ( ) lemma=Expresszug 
 xpre ( ) lemma=express 
 xpreß ( ) lemma=Expreß- 
 xpreß-Abitu ( ) lemma=Expreß-Abitur 
 xpreß-Bu ( ) lemma=Expreß-Bus 
 xpreß-Lo ( ) lemma=Expreß-Lok 
 xpreßabitu ( ) lemma=Expressabitur 
 xpreßbu ( ) lemma=Expressbus 
 xpreßbuslini ( ) lemma=Expressbuslinie 
 xpreßdiens ( ) lemma=Expressdienst 
 xpreßgu ( ) lemma=Expressgut 
 xpreßgutabfertigun ( ) lemma=Expressgutabfertigung 
 xpreßguthall ( ) lemma=Expressguthalle 
 xpreßpaket ( ) lemma=Expresspaket 
 xpreßschalte ( ) lemma=Expressschalter 
 xpreßsendunge ( ) lemma=Expresssendung 
 xpreßtemp ( ) lemma=Expresstempo 
 xpreßzu ( ) lemma=Expresszug 
 xpreßzuge ( ) lemma=Expresszug 
 xpreßzüg ( ) lemma=Expresszug 
 xpreßzüge ( ) lemma=Expresszug 
 xpropriatio ( ) lemma=Expropriation 
 xquisit-Läde ( ) lemma=Exquisit-Laden 
 xquisit ( ) lemma=exquisit 
 xquisite ( ) lemma=exquisit 
 xsoldate ( ) lemma=Exsoldaten 
 xtasy-Tablette ( ) lemma=Extasy-Tablette 
 xtemporiere ( ) lemma=extemporieren 
 xtensio ( ) lemma=Extension 
 xtensiv ( ) lemma=extensiv 
 xter-Str ( ) lemma=Exter-Str. 
 xterieu ( ) lemma=Exterieur 
 xterieurmerkmal ( ) lemma=Exterieurmerkmal 
 xterieur ( ) lemma=Exterieur 
 xtern ( ) lemma=extern 
 xterne ( ) lemma=extern 
 xternenprüfun ( ) lemma=Externenprüfung 
 xternstein ( ) lemma=Externstein 
 xternsteine ( ) lemma=Externstein 
 xterritoriale ( ) lemma=exterritorial 
 xterritorialprinzi ( ) lemma=Exterritorialprinzip 
 xtr ( ) lemma=extra 
 xtra ( ) lemma=extra- 
 xtra-Abteilun ( ) lemma=Extra-Abteilung 
 xtra-Angebot ( ) lemma=Extra-Angebot 
 xtra-Applau ( ) lemma=Extra-Applaus 
 xtra-Ausgab ( ) lemma=Extra-Ausgabe 
 xtra-Blat ( ) lemma=Extra-Blatt 
 xtra-Bonbo ( ) lemma=Extra-Bonbon 
 xtra-Busspure ( ) lemma=Extra-Busspur 
 xtra-Cho ( ) lemma=Extra-Chor 
 xtra-Einnahme ( ) lemma=Extra-Einnahme 
 xtra-Fahr ( ) lemma=Extra-Fahrt 
 xtra-Foli ( ) lemma=Extra-Folie 
 xtra-Gel ( ) lemma=Extra-Geld 
 xtra-Genehmigun ( ) lemma=Extra-Genehmigung 
 xtra-Hilf ( ) lemma=Extra-Hilfe 
 xtra-Klass ( ) lemma=Extra-Klasse 
 xtra-Lo ( ) lemma=Extra-Lob 
 xtra-Loc ( ) lemma=Extra-Loch 
 xtra-Magazi ( ) lemma=Extra-Magazin 
 xtra-Portio ( ) lemma=Extra-Portion 
 xtra-Profi ( ) lemma=Extra-Profit 
 xtra-Profit ( ) lemma=Extra-Profit 
 xtra-Program ( ) lemma=Extra-Programm 
 xtra-Prämi ( ) lemma=Extra-Prämie 
 xtra-Rohrnet ( ) lemma=Extra-Rohrnetz 
 xtra-Schluc ( ) lemma=Extra-Schluck 
 xtra-Servic ( ) lemma=Extra-Service 
 xtra-Spie ( ) lemma=Extra-Spiel 
 xtra-Spielstätt ( ) lemma=Extra-Spielstätte 
 xtra-Spu ( ) lemma=Extra-Spur 
 xtra-Stan ( ) lemma=Extra-Stand 
 xtra-Steuer ( ) lemma=Extra-Steuer 
 xtra-Termi ( ) lemma=Extra-Termin 
 xtra-Tonn ( ) lemma=Extra-Tonne 
 xtra-Tou ( ) lemma=Extra-Tour 
 xtra-Toure ( ) lemma=Extra-Tour 
 xtra-Trasse ( ) lemma=Extra-Trasse 
 xtra-Verordnun ( ) lemma=Extra-Verordnung 
 xtra-Vorstellun ( ) lemma=Extra-Vorstellung 
 xtra-Wahl-Program ( ) lemma=Extra-Wahl-Programm 
 xtra-Warenhäuse ( ) lemma=Extra-Warenhaus 
 xtra-Wurs ( ) lemma=Extra-Wurst 
 xtra-Wünsch ( ) lemma=Extra-Wunsch 
 xtra-Zel ( ) lemma=Extra-Zelt 
 xtra-taz-Tipp ( ) lemma=Extra-taz-Tip 
 xtra-taz-Tip ( ) lemma=Extra-taz-Tip 
 xtraaktio ( ) lemma=Extraaktion 
 xtraangebo ( ) lemma=Extraangebot 
 xtraantra ( ) lemma=Extraantrag 
 xtraapplau ( ) lemma=Extraapplaus 
 xtraausgab ( ) lemma=Extraausgabe 
 xtraausgabe ( ) lemma=Extraausgabe 
 xtrabal ( ) lemma=Extraball 
 xtraberatungsstunde ( ) lemma=Extraberatungsstunde 
 xtrabezahlun ( ) lemma=Extrabezahlung 
 xtrablat ( ) lemma=Extrablatt 
 xtrablätte ( ) lemma=Extrablatt 
 xtrabonbo ( ) lemma=Extrabonbon 
 xtrabonu ( ) lemma=Extrabonus 
 xtraeintrittsprei ( ) lemma=Extraeintrittspreis 
 xtraeta ( ) lemma=Extraetat 
 xtragebüh ( ) lemma=Extragebühr 
 xtragebühre ( ) lemma=Extragebühr 
 xtragel ( ) lemma=Extrageld 
 xtragelde ( ) lemma=Extrageld 
 xtragewinn ( ) lemma=Extragewinn 
 xtraglei ( ) lemma=Extragleis 
 xtragleis ( ) lemma=Extragleis 
 xtrahonora ( ) lemma=Extrahonorar 
 xtrakabine ( ) lemma=Extrakabine 
 xtrakapazitäte ( ) lemma=Extrakapazität 
 xtraklappe ( ) lemma=Extraklappe 
 xtraklass ( ) lemma=Extraklasse 
 xtraklasse ( ) lemma=Extraklasse 
 xtrakohl ( ) lemma=Extrakohle 
 xtrakoste ( ) lemma=Extrakosten 
 xtrak ( ) lemma=Extrakt 
 xtrakt ( ) lemma=Extrakt 
 xtrakte ( ) lemma=Extrakt 
 xtraktio ( ) lemma=Extraktion 
 xtraktions ( ) lemma=Extraktions- 
 xtraktionseffizien ( ) lemma=Extraktionseffizienz 
 xtraktionsgerä ( ) lemma=Extraktionsgerät 
 xtraktionsmethod ( ) lemma=Extraktionsmethode 
 xtraktionsmethode ( ) lemma=Extraktionsmethode 
 xtraktionsrate ( ) lemma=Extraktionsrate 
 xtraleichtgewich ( ) lemma=Extraleichtgewicht 
 xtraleistunge ( ) lemma=Extraleistung 
 xtralo ( ) lemma=Extralob 
 xtraloc ( ) lemma=Extraloch 
 xtramillione ( ) lemma=Extramillion 
 xtramitte ( ) lemma=Extramittel 
 xtramülltonne ( ) lemma=Extramülltonne 
 xtranumme ( ) lemma=Extranummer 
 xtraordinariu ( ) lemma=Extraordinarius 
 xtraordinäre ( ) lemma=extraordinär 
 xtrapflichte ( ) lemma=Extrapflicht 
 xtraplatt ( ) lemma=Extraplatte 
 xtrapolatio ( ) lemma=Extrapolation 
 xtrapolatione ( ) lemma=Extrapolation 
 xtraportio ( ) lemma=Extraportion 
 xtraportione ( ) lemma=Extraportion 
 xtraprofi ( ) lemma=Extraprofit 
 xtraprofit ( ) lemma=Extraprofit 
 xtraprämi ( ) lemma=Extraprämie 
 xtrapunk ( ) lemma=Extrapunkt 
 xtrapunkt ( ) lemma=Extrapunkt 
 xtraratione ( ) lemma=Extraration 
 xtrarau ( ) lemma=Extraraum 
 xtrarechnun ( ) lemma=Extrarechnung 
 xtraregelunge ( ) lemma=Extraregelung 
 xtrarund ( ) lemma=Extrarunde 
 xtrarunde ( ) lemma=Extrarunde 
 xtraschalte ( ) lemma=Extraschalter 
 xtraschich ( ) lemma=Extraschicht 
 xtraschichte ( ) lemma=Extraschicht 
 xtraseite ( ) lemma=Extraseite 
 xtrasemeste ( ) lemma=Extrasemester 
 xtrasens ( ) lemma=Extrasense 
 xtraservic ( ) lemma=Extraservice 
 xtrastrahlun ( ) lemma=Extrastrahlung 
 xtrastunde ( ) lemma=Extrastunde 
 xtratermin ( ) lemma=Extratermin 
 xtratonn ( ) lemma=Extratonne 
 xtratou ( ) lemma=Extratour 
 xtratoure ( ) lemma=Extratour 
 xtravagan ( ) lemma=extravagant 
 xtravagant ( ) lemma=extravagant 
 xtravagante ( ) lemma=extravagant 
 xtravaganze ( ) lemma=Extravaganz 
 xtravergütun ( ) lemma=Extravergütung 
 xtravisio ( ) lemma=Extravision 
 xtravorstellun ( ) lemma=Extravorstellung 
 xtrawache ( ) lemma=Extrawache 
 xtrawurs ( ) lemma=Extrawurst 
 xtrawünsch ( ) lemma=Extrawunsch 
 xtrawürstche ( ) lemma=Extrawürstchen 
 xtrawürst ( ) lemma=Extrawurst 
 xtrawürste ( ) lemma=Extrawurst 
 xtrazahlun ( ) lemma=Extrazahlung 
 xtrazahlunge ( ) lemma=Extrazahlung 
 xtrazimme ( ) lemma=Extrazimmer 
 xtrazüg ( ) lemma=Extrazug 
 xtre ( ) lemma=extrem 
 xtrem-Erlebniss ( ) lemma=Extrem-Erlebnis 
 xtrem-Klettere ( ) lemma=Extrem-Kletterer 
 xtrem-Performance-Künstle ( ) lemma=Extrem-Performance-Künstler 
 xtrem-Positione ( ) lemma=Extrem-Position 
 xtrem-Wandere ( ) lemma=Extrem-Wanderer 
 xtrembedingunge ( ) lemma=Extrembedingung 
 xtrembeispie ( ) lemma=Extrembeispiel 
 xtrembeispiel ( ) lemma=Extrembeispiel 
 xtrembelastunge ( ) lemma=Extrembelastung 
 xtrembergsteige ( ) lemma=Extrembergsteiger 
 xtrembergsteiger ( ) lemma=Extrembergsteiger 
 xtremcellis ( ) lemma=Extremcellist 
 xtrem ( ) lemma=extrem 
 xtreme-Jünger ( ) lemma=Extreme-Jünger 
 xtreme ( ) lemma=extrem 
 xtremfal ( ) lemma=Extremfall 
 xtremfor ( ) lemma=Extremform 
 xtremforme ( ) lemma=Extremform 
 xtremfäll ( ) lemma=Extremfall 
 xtremfälle ( ) lemma=Extremfall 
 xtremgruppe ( ) lemma=Extremgruppe 
 xtremisme ( ) lemma=Extremismus 
 xtremismu ( ) lemma=Extremismus 
 xtremismus-Abteilun ( ) lemma=Extremismus-Abteilung 
 xtremismusbedrohun ( ) lemma=Extremismusbedrohung 
 xtremismusbekämpfun ( ) lemma=Extremismusbekämpfung 
 xtremismusbeobachtun ( ) lemma=Extremismusbeobachtung 
 xtremismusbereic ( ) lemma=Extremismusbereich 
 xtremis ( ) lemma=Extremist 
 xtremiste ( ) lemma=Extremist 
 xtremisten-Date ( ) lemma=Extremisten-Datei 
 xtremisten-Organisatio ( ) lemma=Extremisten-Organisation 
 xtremistenbeschlus ( ) lemma=Extremistenbeschluss 
 xtremistenbeschlusse ( ) lemma=Extremistenbeschluss 
 xtremistenbeschlu ( ) lemma=Extremistenbeschluss 
 xtremistendate ( ) lemma=Extremistendatei 
 xtremistenerlas ( ) lemma=Extremistenerlass 
 xtremistenerlasse ( ) lemma=Extremistenerlass 
 xtremistenerla ( ) lemma=Extremistenerlass 
 xtremistenführe ( ) lemma=Extremistenführer 
 xtremistenführer ( ) lemma=Extremistenführer 
 xtremistengrupp ( ) lemma=Extremistengruppe 
 xtremistengruppe ( ) lemma=Extremistengruppe 
 xtremistenkarte ( ) lemma=Extremistenkartei 
 xtremistenkommando ( ) lemma=Extremistenkommando 
 xtremistenorganisatio ( ) lemma=Extremistenorganisation 
 xtremistenorganisatione ( ) lemma=Extremistenorganisation 
 xtremistenparte ( ) lemma=Extremistenpartei 
 xtremisti ( ) lemma=Extremistin 
 xtremistisch ( ) lemma=extremistisch 
 xtremistische ( ) lemma=extremistisch 
 xtremitä ( ) lemma=Extremität 
 xtremitäte ( ) lemma=Extremität 
 xtremitäten ( ) lemma=Extremitäten- 
 xtremklettere ( ) lemma=Extremkletterer 
 xtremkletterer ( ) lemma=Extremkletterer 
 xtremkletter ( ) lemma=Extremklettern 
 xtremleistunge ( ) lemma=Extremleistung 
 xtremlösunge ( ) lemma=Extremlösung 
 xtrempositio ( ) lemma=Extremposition 
 xtrempositione ( ) lemma=Extremposition 
 xtrempunk ( ) lemma=Extrempunkt 
 xtrempunkt ( ) lemma=Extrempunkt 
 xtremsekte ( ) lemma=Extremsekte 
 xtremsituatio ( ) lemma=Extremsituation 
 xtremsituatione ( ) lemma=Extremsituation 
 xtremsportle ( ) lemma=Extremsportler 
 xtremst ( ) lemma=extrem 
 xtremtemperature ( ) lemma=Extremtemperatur 
 xtremwert ( ) lemma=Extremwert 
 xtremwerte ( ) lemma=Extremwert 
 xtremwinte ( ) lemma=Extremwinter 
 xtrovertiert ( ) lemma=extrovertiert 
 xtrovertierte ( ) lemma=extrovertiert 
 xvorsitzend ( ) lemma=Exvorsitzender 
 xxon ( ) lemma=Exxon- 
 xxon-Beschäftigt ( ) lemma=Exxon-Beschäftigte 
 xxon-Che ( ) lemma=Exxon-Chef 
 xxon-Gelde ( ) lemma=Exxon-Geld 
 xxon-Katastroph ( ) lemma=Exxon-Katastrophe 
 xxon-Konzer ( ) lemma=Exxon-Konzern 
 xxon-Konzern ( ) lemma=Exxon-Konzern 
 xxon-Kreditkarte ( ) lemma=Exxon-Kreditkarte 
 xxon-Managemen ( ) lemma=Exxon-Management 
 xxon-Man ( ) lemma=Exxon-Mann 
 xxon-Präsiden ( ) lemma=Exxon-Präsident 
 xxon-Spreche ( ) lemma=Exxon-Sprecher 
 xxon-Tanke ( ) lemma=Exxon-Tanker 
 xxon-Tankstelle ( ) lemma=Exxon-Tankstelle 
 xxon-Tochte ( ) lemma=Exxon-Tochter 
 xxon-Valdez-Katastroph ( ) lemma=Exxon-Valdez-Katastrophe 
 xxon-Zentral ( ) lemma=Exxon-Zentrale 
 xxon-Ö ( ) lemma=Exxon-Öl 
 xzellent ( ) lemma=exzellent 
 xzellente ( ) lemma=exzellent 
 xzellen ( ) lemma=exzellent 
 xzellenze ( ) lemma=Exzellenz 
 xzellenzhau ( ) lemma=Exzellenzhaus 
 xzentri ( ) lemma=Exzentrik 
 xzentrike ( ) lemma=Exzentriker 
 xzentrikeri ( ) lemma=Exzentrikerin 
 xzentriker ( ) lemma=Exzentriker 
 xzentrisch ( ) lemma=exzentrisch 
 xzentrische ( ) lemma=exzentrisch 
 xzentrizitä ( ) lemma=Exzentrizität 
 xzerpt ( ) lemma=Exzerpt 
 xzes ( ) lemma=Exzess 
 xzess ( ) lemma=Exzess 
 xzesse ( ) lemma=Exzess 
 xzessiv ( ) lemma=exzessiv 
 xzessive ( ) lemma=exzessiv 
 xzessmord ( ) lemma=Exzessmord 
 xzessta ( ) lemma=Exzesstat 
 xzesstate ( ) lemma=Exzesstat 
 xzesstäte ( ) lemma=Exzesstäter 
 xze ( ) lemma=Exzess 
 xzeßmord ( ) lemma=Exzessmord 
 xzeßta ( ) lemma=Exzesstat 
 xzeßtate ( ) lemma=Exzesstat 
 xzeßtäte ( ) lemma=Exzesstäter 
 X-Galeri ( ) lemma=KX-Galerie 
 X-Interkontinentalraket ( ) lemma=MX-Interkontinentalrakete 
 X-Interkontinentalrakete ( ) lemma=MX-Interkontinentalrakete 
 X-Raket ( ) lemma=MX-Rakete 
 X-Rakete ( ) lemma=MX-Rakete 
 X-REKLAM ( ) lemma=OX-REKLAME 
 xan ( ) lemma=Oxana 
 xfor ( ) lemma=Oxford 
 xford ( ) lemma=Oxford 
 xford-Absolven ( ) lemma=Oxford-Absolvent 
 xford-Akzen ( ) lemma=Oxford-Akzent 
 xford-Professo ( ) lemma=Oxford-Professor 
 xford-Sinfoni ( ) lemma=Oxford-Sinfonie 
 xford-Studen ( ) lemma=Oxford-Student 
 xforde ( ) lemma=Oxforder 
 xfort-Tou ( ) lemma=Oxfort-Tour 
 xidatio ( ) lemma=Oxidation 
 xidatione ( ) lemma=Oxidation 
 xidations-Katalysato ( ) lemma=Oxidations-Katalysator 
 xidationsfilte ( ) lemma=Oxidationsfilter 
 xidationsmitte ( ) lemma=oxidationsmittel 
 xidationsstuf ( ) lemma=Oxidationsstufe 
 xidationsverhalten ( ) lemma=Oxidationsverhalten 
 xid ( ) lemma=Oxid 
 xidierend ( ) lemma=oxidierend 
 xidlage ( ) lemma=Oxidlager 
 xleas-Wal ( ) lemma=Oxleas-Wald 
 xy ( ) lemma=Oxyd 
 xydatio ( ) lemma=Oxydation 
 xydationsfilte ( ) lemma=Oxydationsfilter 
 xydationskatalysato ( ) lemma=Oxydationskatalysator 
 xydationsmitte ( ) lemma=Oxydationsmittel 
 xyd ( ) lemma=Oxyd 
 xymoro ( ) lemma=Oxymoron 
 X-Geländ ( ) lemma=PX-Gelände 
 X-Lade ( ) lemma=PX-Laden 
 X-beliebig ( ) 
 XS-Sensore ( ) lemma=XXS-Sensor 
 XXS-Sensor ( ) 
 Xenie|Xenion ( ) 
 Xeno-Transplantation ( ) 
 Xhosa-Stamm ( ) 
 x8 ( ) lemma=Zx80 
 xiomatisc ( ) lemma=axiomatisch 
 xiomatisch ( ) lemma=axiomatisch 
 x-grüne ( ) lemma=ex-grün 
 x-jugoslawische ( ) lemma=ex-jugoslawisch 
 x-kommunistisch ( ) lemma=ex-kommunistisch 
 x-linke ( ) lemma=ex-link 
 x-sowjetisch ( ) lemma=ex-sowjetisch 
 x-sowjetische ( ) lemma=ex-sowjetisch 
 x-sozialistische ( ) lemma=ex-sozialistisch 
 xak ( ) lemma=exakt 
 xakter ( ) lemma=exakt 
 xaktere ( ) lemma=exakt 
 xaktest ( ) lemma=exakt 
 xakteste ( ) lemma=exakt 
 xaltier ( ) lemma=exaltiert 
 xaltierte ( ) lemma=exaltiert 
 xaminiere ( ) lemma=examinieren 
 xaminier ( ) lemma=examinieren 
 xaminierte ( ) lemma=examiniert 
 xekutierende ( ) lemma=exekutierend 
 xekutier ( ) lemma=exekutieren 
 xekutiert ( ) lemma=exekutiert 
 xekuti ( ) lemma=exekutiv 
 xemplarisc ( ) lemma=exemplarisch 
 xemplifiziere ( ) lemma=exemplifizieren 
 xemplifizier ( ) lemma=exemplifizieren 
 xemplifiziert ( ) lemma=exemplifiziert 
 xemplifizierte ( ) lemma=exemplifiziert 
 xerzierende ( ) lemma=exerzierend 
 xerzier ( ) lemma=exerzieren 
 xerziert ( ) lemma=exerziert 
 xerzierte ( ) lemma=exerziert 
 xilier ( ) lemma=exiliert 
 xilkubanisch ( ) lemma=exilkubanisch 
 xilkubanische ( ) lemma=exilkubanisch 
 xilpolitisch ( ) lemma=exilpolitisch 
 xilpolitische ( ) lemma=exilpolitischer 
 xilrussisch ( ) lemma=exilrussisch 
 xilrussische ( ) lemma=exilrussisch 
 xistent ( ) lemma=existent 
 xistente ( ) lemma=existent 
 xistentia ( ) lemma=existential 
 xistentiel ( ) lemma=existentiell 
 xistentieller ( ) lemma=existentiell 
 xistentiellere ( ) lemma=existentiell 
 xistentiellst ( ) lemma=existentiell 
 xistenzbedrohen ( ) lemma=existenzbedrohend 
 xistenzbedrohende ( ) lemma=existenzbedrohend 
 xistenzbedroh ( ) lemma=existenzbedroht 
 xistenzbedroht ( ) lemma=existenzbedroht 
 xistenzbedrohte ( ) lemma=existenzbedroht 
 xistenzfähi ( ) lemma=existenzfähig 
 xistenzgefährden ( ) lemma=existenzgefährdend 
 xistenzgefährdend ( ) lemma=existenzgefährdend 
 xistenzgefährdende ( ) lemma=existenzgefährdend 
 xistenzgefährde ( ) lemma=existenzgefährdet 
 xistenzgefährdete ( ) lemma=existenzgefährdet 
 xistenziel ( ) lemma=existentiell 
 xistenzieller ( ) lemma=existentiell 
 xistenziellere ( ) lemma=existentiell 
 xistenziellst ( ) lemma=existentiell 
 xistenznotwendi ( ) lemma=existenznotwendig 
 xistenznotwendig ( ) lemma=existenznotwendig 
 xistenznotwendige ( ) lemma=existenznotwendig 
 xistenzphilosophische ( ) lemma=existenzphilosophisch 
 xistenzsichern ( ) lemma=existenzsichernd 
 xistenzsichernd ( ) lemma=existenzsichernd 
 xistenzsichernde ( ) lemma=existenzsichernd 
 xistenzvernichtend ( ) lemma=existenzvernichtend 
 xistenzvernichtende ( ) lemma=existenzvernichtend 
 xistier ( ) lemma=existiert 
 xistiers ( ) lemma=existieren 
 xistierte ( ) lemma=existiert 
 xklusi ( ) lemma=exklusiv 
 xklusiver ( ) lemma=exklusiv 
 xklusivere ( ) lemma=exklusiv 
 xklusivste ( ) lemma=exklusiv 
 xkommuniziere ( ) lemma=exkommunizieren 
 xkommunizier ( ) lemma=exkommunizieren 
 xkommuniziert ( ) lemma=exkommuniziert 
 xkommunizierte ( ) lemma=exkommuniziert 
 xkulpiere ( ) lemma=exkulpieren 
 xkulpier ( ) lemma=exkulpieren 
 xorbitan ( ) lemma=exorbitant 
 xorbitante ( ) lemma=exorbitant 
 xorzier ( ) lemma=exorzieren 
 xorziert ( ) lemma=exorziert 
 xoterisch ( ) lemma=exoterisch 
 xotisc ( ) lemma=exotisch 
 xotischer ( ) lemma=exotisch 
 xotischere ( ) lemma=exotisch 
 xotischst ( ) lemma=exotisch 
 xotischste ( ) lemma=exotisch 
 xpandier ( ) lemma=expandieren 
 xpandieren ( ) lemma=expandierend 
 xpandierend ( ) lemma=expandierend 
 xpandierende ( ) lemma=expandierend 
 xpandiert ( ) lemma=expandiert 
 xpandierte ( ) lemma=expandiert 
 xpansionistisc ( ) lemma=expansionistisch 
 xpansionistisch ( ) lemma=expansionistisch 
 xpansionistische ( ) lemma=expansionistisch 
 xpansionsfreudige ( ) lemma=expansionsfreudig 
 xpansionshungrig ( ) lemma=expansionshungrig 
 xpansionslüsterne ( ) lemma=expansionslüstern 
 xpansi ( ) lemma=expansiv 
 xpansiv ( ) lemma=expansiv 
 xpansive ( ) lemma=expansiv 
 xpansivst ( ) lemma=expansiv 
 xpansivste ( ) lemma=expansiv 
 xpatriiert ( ) lemma=expatriiert 
 xpediere ( ) lemma=expedieren 
 xpedier ( ) lemma=expedieren 
 xpediert ( ) lemma=expediert 
 xpensiv ( ) lemma=expensiv 
 xperimenta ( ) lemma=experimental 
 xperimentale ( ) lemma=experimental 
 xperimentel ( ) lemma=experimentell 
 xperimenteller ( ) lemma=experimentell 
 xperimentierend ( ) lemma=experimentierend 
 xperimentierende ( ) lemma=experimentierend 
 xperimentierfreudi ( ) lemma=experimentierfreudig 
 xperimentierfreudig ( ) lemma=experimentierfreudig 
 xperimentiert ( ) lemma=experimentiert 
 xperimentierte ( ) lemma=experimentiert 
 xpliziere ( ) lemma=explizieren 
 xplizier ( ) lemma=explizieren 
 xpliziert ( ) lemma=expliziert 
 xplizi ( ) lemma=explizit 
 xplodier ( ) lemma=explodieren 
 xplodieren ( ) lemma=explodierend 
 xplodierende ( ) lemma=explodierend 
 xplodiert ( ) lemma=explodiert 
 xplodierte ( ) lemma=explodiert 
 xplorativ ( ) lemma=explorativ 
 xploriere ( ) lemma=explorieren 
 xplorier ( ) lemma=explorieren 
 xplosionsarti ( ) lemma=explosionsartig 
 xplosionsfähig ( ) lemma=explosionsfähig 
 xplosionsfähige ( ) lemma=explosionsfähig 
 xplosionsgefährdete ( ) lemma=explosionsgefährdet 
 xplosionsgefährlich ( ) lemma=explosionsgefährlich 
 xplosionsgeschützt ( ) lemma=explosionsgeschützt 
 xplosi ( ) lemma=explosiv 
 xplosiv-dynamische ( ) lemma=explosiv-dynamisch 
 xplosiver ( ) lemma=explosiv 
 xplosivere ( ) lemma=explosiv 
 xplosivst ( ) lemma=explosiv 
 xplosivste ( ) lemma=explosiv 
 xponentiel ( ) lemma=exponentiell 
 xponentiell ( ) lemma=exponentiell 
 xponentielle ( ) lemma=exponentiell 
 xponenziel ( ) lemma=exponentiell 
 xponenziell ( ) lemma=exponentiell 
 xponenzielle ( ) lemma=exponentiell 
 xponierende ( ) lemma=exponierend 
 xponier ( ) lemma=exponieren 
 xponierte ( ) lemma=exponiert 
 xponiertest ( ) lemma=exponiert 
 xponierteste ( ) lemma=exponiert 
 xport-orientiert ( ) lemma=export-orientiert 
 xportabhängi ( ) lemma=exportabhängig 
 xportabhängig ( ) lemma=exportabhängig 
 xportabhängige ( ) lemma=exportabhängig 
 xportfreudige ( ) lemma=exportfreudig 
 xportfähi ( ) lemma=exportfähig 
 xportfähig ( ) lemma=exportfähig 
 xportfähige ( ) lemma=exportfähig 
 xportier ( ) lemma=exportieren 
 xportierend ( ) lemma=exportierend 
 xportierende ( ) lemma=exportierend 
 xportierte ( ) lemma=exportiert 
 xportintensiv ( ) lemma=exportintensiv 
 xportorientier ( ) lemma=exportorientiert 
 xportorientiert ( ) lemma=exportorientiert 
 xportorientierte ( ) lemma=exportorientiert 
 xportpolitische ( ) lemma=exportpolitisch 
 xportstark ( ) lemma=exportstark 
 xportstarke ( ) lemma=exportstark 
 xportstärkste ( ) lemma=exportstark 
 xpressdemokratisierte ( ) lemma=expressdemokratisiert 
 xpressionistisch-holzschnittartige ( ) lemma=expressionistisch-holzschnittartiger 
 xpressi ( ) lemma=expressiv 
 xpressiver ( ) lemma=expressiv 
 xpressivere ( ) lemma=expressiv 
 xquisi ( ) lemma=exquisit 
 xtatisch ( ) lemma=extatisch 
 xtemporier ( ) lemma=extemporieren 
 xtensi ( ) lemma=extensiv 
 xtensive ( ) lemma=extensiv 
 xtensiver ( ) lemma=extensiv 
 xter ( ) lemma=extern 
 xterritoria ( ) lemma=exterritorial 
 xterritorial ( ) lemma=exterritorial 
 xtra-ordinäre ( ) lemma=extra-ordinär 
 xtrabrei ( ) lemma=extrabreit 
 xtrabreite ( ) lemma=extrabreit 
 xtrageheime ( ) lemma=extrageheim 
 xtrahiere ( ) lemma=extrahieren 
 xtrahier ( ) lemma=extrahiert 
 xtrahiert ( ) lemma=extrahiert 
 xtralang ( ) lemma=extralang 
 xtralange ( ) lemma=extralang 
 xtralegal ( ) lemma=extralegal 
 xtralegale ( ) lemma=extralegal 
 xtraordinä ( ) lemma=extraordinär 
 xtraordinär ( ) lemma=extraordinär 
 xtrapolier ( ) lemma=extrapoliert 
 xtraschöne ( ) lemma=extraschön 
 xtrastar ( ) lemma=extrastark 
 xtrastarke ( ) lemma=extrastark 
 xtraterrestrisch ( ) lemma=extraterrestrisch 
 xtraterrestrische ( ) lemma=extraterrestrisch 
 xtraterritorial ( ) lemma=extraterritorial 
 xtraterritoriale ( ) lemma=extraterritorial 
 xtravaganteste ( ) lemma=extravagant 
 xtrawei ( ) lemma=extraweit 
 xtrem-nationalistische ( ) lemma=extrem-nationalistisch 
 xtrem-problematisch ( ) lemma=extrem-problematisch 
 xtremer ( ) lemma=extrem 
 xtremere ( ) lemma=extrem 
 xtremistisc ( ) lemma=extremistisch 
 xtremste ( ) lemma=extrem 
 xtrovertier ( ) lemma=extrovertiert 
 xzentrisc ( ) lemma=exzentrisch 
 xzeptionel ( ) lemma=exzeptionell 
 xzeptionell ( ) lemma=exzeptionell 
 xzeptionelle ( ) lemma=exzeptionell 
 xzessi ( ) lemma=exzessiv 
 xzessivst ( ) lemma=exzessiv 
 xidierbare ( ) lemma=oxidierbar 
 xidierende ( ) lemma=oxidierend 
 xidier ( ) lemma=oxidiert 
 xidierte ( ) lemma=oxidiert 
 xydier ( ) lemma=oxydieren 
 xydiert ( ) lemma=oxydiert 
 xydierte ( ) lemma=oxydiert 
